"date","code","region","name","AE_att_T1","AE_att_T2","AE_att_T3","AE_att_tot","AE_more4_T1","AE_more4_T2","AE_more4_T3","AE_more4_tot","AE_per4_T1","AE_per4_all","Em_adm_AE_T1","Em_adm_AE_T2","Em_adm_AE_T34","Em_adm_AE_tot","Em_adm_other","Em_adm_tot","Em_pat_adm_more4","Em_pat_adm_more12","time_period","file_name","day_num"
2025-03-01,"RC9","NHS England East Of England","Bedfordshire Hospitals NHS Foundation Trust",17026,0,9599,26625,7473,0,0,7473,0.561083049453777,0.719323943661972,4678,0,0,4678,2325,7003,9,9,"March 2025","March-2025-AE-by-provider-cAki3.xls",59
2025-03-01,"RGT","NHS England East Of England","Cambridge University Hospitals NHS Foundation Trust",11282,0,6535,17817,4957,0,135,5092,0.560627548307038,0.714205534040523,2764,0,35,2799,436,3235,1030,417,"March 2025","March-2025-AE-by-provider-cAki3.xls",59
2025-03-01,"RWH","NHS England East Of England","East And North Hertfordshire NHS Trust",9225,0,8769,17994,4607,0,109,4716,0.50059620596206,0.737912637545848,2849,0,3,2852,228,3080,407,170,"March 2025","March-2025-AE-by-provider-cAki3.xls",59
2025-03-01,"RDE","NHS England East Of England","East Suffolk And North Essex NHS Foundation Trust",13117,0,15563,28680,5648,0,555,6203,0.569413737897385,0.783716875871688,6306,0,386,6692,1212,7904,1709,733,"March 2025","March-2025-AE-by-provider-cAki3.xls",59
2025-03-01,"RY4","NHS England East Of England","Hertfordshire Community NHS Trust",0,0,1223,1223,0,0,38,38,NA,0.968928863450532,0,0,0,0,0,0,0,0,"March 2025","March-2025-AE-by-provider-cAki3.xls",59
2025-03-01,"DT301","NHS England East Of England","Herts Urgent Care (Ascots Lane)",0,0,2413,2413,0,0,124,124,NA,0.948611686697058,0,0,0,0,0,0,0,0,"March 2025","March-2025-AE-by-provider-cAki3.xls",59
2025-03-01,"RGP","NHS England East Of England","James Paget University Hospitals NHS Foundation Trust",7416,0,1608,9024,3330,0,0,3330,0.550970873786408,0.630984042553192,1676,0,0,1676,504,2180,1039,457,"March 2025","March-2025-AE-by-provider-cAki3.xls",59
2025-03-01,"RAJ","NHS England East Of England","Mid And South Essex NHS Foundation Trust",31805,0,3966,35771,11582,0,311,11893,0.635843420845779,0.667523971932571,8531,0,174,8705,1285,9990,3182,627,"March 2025","March-2025-AE-by-provider-cAki3.xls",59
2025-03-01,"RD8","NHS England East Of England","Milton Keynes University Hospital NHS Foundation Trust",9251,0,5488,14739,3373,0,392,3765,0.63539076856556,0.744555261550987,2260,0,0,2260,446,2706,897,0,"March 2025","March-2025-AE-by-provider-cAki3.xls",59
2025-03-01,"RM1","NHS England East Of England","Norfolk And Norwich University Hospitals NHS Foundation Trust",12804,0,8381,21185,3867,0,0,3867,0.697985004686036,0.817465187632759,2482,0,0,2482,1599,4081,1169,255,"March 2025","March-2025-AE-by-provider-cAki3.xls",59
2025-03-01,"RGN","NHS England East Of England","North West Anglia NHS Foundation Trust",15288,0,5141,20429,6512,0,211,6723,0.574045002616431,0.670909001909051,3714,0,32,3746,1592,5338,1371,889,"March 2025","March-2025-AE-by-provider-cAki3.xls",59
2025-03-01,"Y02428","NHS England East Of England","Putnoe Walk In Centre",0,0,3139,3139,0,0,0,0,NA,1,0,0,0,0,0,0,0,0,"March 2025","March-2025-AE-by-provider-cAki3.xls",59
2025-03-01,"RQW","NHS England East Of England","The Princess Alexandra Hospital NHS Trust",8544,0,2796,11340,3474,0,0,3474,0.593398876404494,0.693650793650794,1795,0,0,1795,277,2072,490,89,"March 2025","March-2025-AE-by-provider-cAki3.xls",59
2025-03-01,"RCX","NHS England East Of England","The Queen Elizabeth Hospital, King's Lynn, NHS Foundation Trust",6746,0,1246,7992,3185,0,0,3185,0.527868366439372,0.601476476476477,1909,0,0,1909,373,2282,413,128,"March 2025","March-2025-AE-by-provider-cAki3.xls",59
2025-03-01,"RWG","NHS England East Of England","West Hertfordshire Teaching Hospitals NHS Trust",8729,0,8460,17189,2928,0,187,3115,0.664566387902394,0.8187794519751,4279,0,0,4279,619,4898,847,28,"March 2025","March-2025-AE-by-provider-cAki3.xls",59
2025-03-01,"RGR","NHS England East Of England","West Suffolk NHS Foundation Trust",8292,0,798,9090,1055,0,0,1055,0.872768933912204,0.883938393839384,2117,0,0,2117,300,2417,284,69,"March 2025","March-2025-AE-by-provider-cAki3.xls",59
2025-03-01,"G0Q0L","NHS England London","Barking Hospital Utc",0,0,2910,2910,0,0,30,30,NA,0.989690721649484,0,0,0,0,0,0,0,0,"March 2025","March-2025-AE-by-provider-cAki3.xls",59
2025-03-01,"RF4","NHS England London","Barking, Havering And Redbridge University Hospitals NHS Trust",13687,2482,15017,31186,6204,385,151,6740,0.546723167969606,0.783877380876034,8016,0,0,8016,415,8431,1623,928,"March 2025","March-2025-AE-by-provider-cAki3.xls",59
2025-03-01,"R1H","NHS England London","Barts Health NHS Trust",25830,973,18069,44872,11735,53,1279,13067,0.545683313975997,0.708793902656445,4556,0,46,4602,1117,5719,2232,990,"March 2025","March-2025-AE-by-provider-cAki3.xls",59
2025-03-01,"AD913","NHS England London","Beckenham Beacon Ucc",0,0,4089,4089,0,0,11,11,NA,0.997309855710443,0,0,0,0,0,0,0,0,"March 2025","March-2025-AE-by-provider-cAki3.xls",59
2025-03-01,"RYX","NHS England London","Central London Community Healthcare NHS Trust",0,0,13349,13349,0,0,416,416,NA,0.968836616975054,0,0,0,0,0,0,0,0,"March 2025","March-2025-AE-by-provider-cAki3.xls",59
2025-03-01,"RQM","NHS England London","Chelsea And Westminster Hospital NHS Foundation Trust",20669,0,6486,27155,5353,0,102,5455,0.741013111422904,0.799116184864666,2869,0,0,2869,307,3176,988,55,"March 2025","March-2025-AE-by-provider-cAki3.xls",59
2025-03-01,"RJ6","NHS England London","Croydon Health Services NHS Trust",13255,0,5119,18374,3289,0,0,3289,0.751867219917012,0.820997061064548,1214,0,0,1214,118,1332,1005,701,"March 2025","March-2025-AE-by-provider-cAki3.xls",59
2025-03-01,"RVR","NHS England London","Epsom And St Helier University Hospitals NHS Trust",11860,328,1530,13718,3440,0,109,3549,0.709949409780776,0.741288817611897,1911,3,0,1914,188,2102,959,706,"March 2025","March-2025-AE-by-provider-cAki3.xls",59
2025-03-01,"RJ1","NHS England London","Guy's And St Thomas' NHS Foundation Trust",10247,727,7130,18104,3568,12,199,3779,0.651800526983507,0.791261599646487,2054,0,0,2054,220,2274,190,71,"March 2025","March-2025-AE-by-provider-cAki3.xls",59
2025-03-01,"K6K0R","NHS England London","Harold Wood Polyclinic Utc",0,0,2364,2364,0,0,5,5,NA,0.997884940778342,0,0,0,0,0,0,0,0,"March 2025","March-2025-AE-by-provider-cAki3.xls",59
2025-03-01,"RQX","NHS England London","Homerton Healthcare NHS Foundation Trust",11231,0,0,11231,1927,0,0,1927,0.828421333808209,0.828421333808209,1842,0,0,1842,349,2191,228,22,"March 2025","March-2025-AE-by-provider-cAki3.xls",59
2025-03-01,"RYJ","NHS England London","Imperial College Healthcare NHS Trust",12089,3928,7706,23723,5333,45,349,5727,0.558855157581272,0.758588711377144,3707,1,0,3708,1110,4818,1037,387,"March 2025","March-2025-AE-by-provider-cAki3.xls",59
2025-03-01,"RJZ","NHS England London","King's College Hospital NHS Foundation Trust",15770,0,10720,26490,6803,0,563,7366,0.56861128725428,0.721932804832012,3585,0,0,3585,366,3951,2367,926,"March 2025","March-2025-AE-by-provider-cAki3.xls",59
2025-03-01,"RAX","NHS England London","Kingston And Richmond NHS Foundation Trust",7332,0,8910,16242,3271,0,273,3544,0.553873431533006,0.781800270902598,2435,0,278,2713,322,3035,679,406,"March 2025","March-2025-AE-by-provider-cAki3.xls",59
2025-03-01,"RJ2","NHS England London","Lewisham And Greenwich NHS Trust",15526,0,10605,26131,8134,0,817,8951,0.476104598737602,0.657456660671233,5027,0,0,5027,1262,6289,2172,854,"March 2025","March-2025-AE-by-provider-cAki3.xls",59
2025-03-01,"R1K","NHS England London","London North West University Healthcare NHS Trust",14125,0,15651,29776,6324,0,194,6518,0.552283185840708,0.781098871574422,6751,0,0,6751,336,7087,1001,367,"March 2025","March-2025-AE-by-provider-cAki3.xls",59
2025-03-01,"RP6","NHS England London","Moorfields Eye Hospital NHS Foundation Trust",0,5789,0,5789,0,92,0,92,NA,0.984107790637416,0,6,0,6,202,208,0,0,"March 2025","March-2025-AE-by-provider-cAki3.xls",59
2025-03-01,"RAT","NHS England London","North East London NHS Foundation Trust",0,0,2006,2006,0,0,75,75,NA,0.962612163509472,0,0,0,0,0,0,0,0,"March 2025","March-2025-AE-by-provider-cAki3.xls",59
2025-03-01,"RAL","NHS England London","Royal Free London NHS Foundation Trust",25567,541,16868,42976,9852,6,972,10830,0.61465952204013,0.747998883097543,4698,0,51,4749,779,5528,3040,1838,"March 2025","March-2025-AE-by-provider-cAki3.xls",59
2025-03-01,"RAN","NHS England London","Royal National Orthopaedic Hospital NHS Trust",0,0,0,0,0,0,0,0,NA,NA,0,0,0,0,27,27,0,0,"March 2025","March-2025-AE-by-provider-cAki3.xls",59
2025-03-01,"RJ7","NHS England London","St George's University Hospitals NHS Foundation Trust",9841,0,3515,13356,2185,0,0,2185,0.77796971852454,0.836403114705002,2738,0,0,2738,793,3531,1181,780,"March 2025","March-2025-AE-by-provider-cAki3.xls",59
2025-03-01,"RAS","NHS England London","The Hillingdon Hospitals NHS Foundation Trust",6236,0,6892,13128,3123,0,56,3179,0.499198203976908,0.757845825716027,1883,0,0,1883,57,1940,835,69,"March 2025","March-2025-AE-by-provider-cAki3.xls",59
2025-03-01,"Y03218","NHS England London","The Pinn Unregistered Wic",0,0,603,603,0,0,0,0,NA,1,0,0,0,0,0,0,0,0,"March 2025","March-2025-AE-by-provider-cAki3.xls",59
2025-03-01,"RRV","NHS England London","University College London Hospitals NHS Foundation Trust",13948,0,0,13948,3789,0,0,3789,0.72834815027244,0.72834815027244,1443,0,0,1443,276,1719,465,80,"March 2025","March-2025-AE-by-provider-cAki3.xls",59
2025-03-01,"Y02147","NHS England London","Urgent Care Centre (Qms)",0,0,8643,8643,0,0,184,184,NA,0.978711095684369,0,0,0,0,0,0,0,0,"March 2025","March-2025-AE-by-provider-cAki3.xls",59
2025-03-01,"RKE","NHS England London","Whittington Health NHS Trust",9282,0,0,9282,2600,0,0,2600,0.719887955182073,0.719887955182073,1364,0,0,1364,39,1403,339,71,"March 2025","March-2025-AE-by-provider-cAki3.xls",59
2025-03-01,"NL7","NHS England Midlands","Assura Vertis Urgent Care Centres (Birmingham)",0,0,3164,3164,0,0,0,0,NA,1,0,0,0,0,0,0,0,0,"March 2025","March-2025-AE-by-provider-cAki3.xls",59
2025-03-01,"8J094","NHS England Midlands","Badger Ltd",0,0,1438,1438,0,0,0,0,NA,1,0,0,0,0,0,0,0,0,"March 2025","March-2025-AE-by-provider-cAki3.xls",59
2025-03-01,"RQ3","NHS England Midlands","Birmingham Women's And Children's NHS Foundation Trust",5330,0,0,5330,656,0,0,656,0.876923076923077,0.876923076923077,1091,0,0,1091,151,1242,7,7,"March 2025","March-2025-AE-by-provider-cAki3.xls",59
2025-03-01,"RFS","NHS England Midlands","Chesterfield Royal Hospital NHS Foundation Trust",7422,0,6913,14335,3761,0,423,4184,0.49326327135543,0.708126961981165,2725,0,289,3014,696,3710,990,167,"March 2025","March-2025-AE-by-provider-cAki3.xls",59
2025-03-01,"RYG","NHS England Midlands","Coventry And Warwickshire Partnership NHS Trust",0,0,0,0,0,0,0,0,NA,NA,0,0,3,3,71,74,0,0,"March 2025","March-2025-AE-by-provider-cAki3.xls",59
2025-03-01,"RY8","NHS England Midlands","Derbyshire Community Health Services NHS Foundation Trust",0,0,9607,9607,0,0,129,129,NA,0.986572291037785,0,0,0,0,0,0,0,0,"March 2025","March-2025-AE-by-provider-cAki3.xls",59
2025-03-01,"NNJ","NHS England Midlands","Dhu Health Care C.I.C",0,0,2055,2055,0,0,0,0,NA,1,0,0,0,0,0,0,0,0,"March 2025","March-2025-AE-by-provider-cAki3.xls",59
2025-03-01,"Y03007","NHS England Midlands","Erdington GP Health & Wellbeing Wic",0,0,1942,1942,0,0,0,0,NA,1,0,0,0,0,0,0,0,0,"March 2025","March-2025-AE-by-provider-cAki3.xls",59
2025-03-01,"RLT","NHS England Midlands","George Eliot Hospital NHS Trust",7182,0,1690,8872,2920,0,65,2985,0.593428014480646,0.663548241659152,1093,0,0,1093,1,1094,791,338,"March 2025","March-2025-AE-by-provider-cAki3.xls",59
2025-03-01,"RNQ","NHS England Midlands","Kettering General Hospital NHS Foundation Trust",10604,0,8943,19547,3696,0,174,3870,0.651452282157676,0.80201565457615,1799,0,0,1799,294,2093,1304,891,"March 2025","March-2025-AE-by-provider-cAki3.xls",59
2025-03-01,"C82038","NHS England Midlands","Latham House Medical Practice",0,0,350,350,0,0,0,0,NA,1,0,0,0,0,0,0,0,0,"March 2025","March-2025-AE-by-provider-cAki3.xls",59
2025-03-01,"RY5","NHS England Midlands","Lincolnshire Community Health Services NHS Trust",0,0,8775,8775,0,0,250,250,NA,0.971509971509972,0,0,0,0,0,0,0,0,"March 2025","March-2025-AE-by-provider-cAki3.xls",59
2025-03-01,"NNJ0H","NHS England Midlands","Llr Ea - The Merlyn Vaz Health & Social Care Centre",0,0,2412,2412,0,0,0,0,NA,1,0,0,0,0,0,0,0,0,"March 2025","March-2025-AE-by-provider-cAki3.xls",59
2025-03-01,"NNJ07","NHS England Midlands","Loughborough Urgent Care Centre",0,0,8172,8172,0,0,28,28,NA,0.99657366617719,0,0,0,0,0,0,0,0,"March 2025","March-2025-AE-by-provider-cAki3.xls",59
2025-03-01,"NNJ12","NHS England Midlands","Market Harborough",0,0,581,581,0,0,0,0,NA,1,0,0,0,0,0,0,0,0,"March 2025","March-2025-AE-by-provider-cAki3.xls",59
2025-03-01,"C82009","NHS England Midlands","Market Harborough Med.Ctr",0,0,315,315,0,0,0,0,NA,1,0,0,0,0,0,0,0,0,"March 2025","March-2025-AE-by-provider-cAki3.xls",59
2025-03-01,"NNJ13","NHS England Midlands","Melton Mowbray",0,0,451,451,0,0,0,0,NA,1,0,0,0,0,0,0,0,0,"March 2025","March-2025-AE-by-provider-cAki3.xls",59
2025-03-01,"A5D4Q","NHS England Midlands","Nems Utc",0,0,3681,3681,0,0,1464,1464,NA,0.602281988590057,0,0,0,0,0,0,0,0,"March 2025","March-2025-AE-by-provider-cAki3.xls",59
2025-03-01,"RNS","NHS England Midlands","Northampton General Hospital NHS Trust",10470,527,2603,13600,4372,15,268,4655,0.582425978987584,0.657720588235294,2348,0,0,2348,891,3239,1336,674,"March 2025","March-2025-AE-by-provider-cAki3.xls",59
2025-03-01,"NR3","NHS England Midlands","Nottingham Citycare Partnership",0,0,6067,6067,0,0,721,721,NA,0.881160375803527,0,0,0,0,0,0,0,0,"March 2025","March-2025-AE-by-provider-cAki3.xls",59
2025-03-01,"RX1","NHS England Midlands","Nottingham University Hospitals NHS Trust",13574,1817,567,15958,7275,82,141,7498,0.464048917047296,0.530141621757112,4380,184,0,4564,4583,9147,743,533,"March 2025","March-2025-AE-by-provider-cAki3.xls",59
2025-03-01,"NNJ14","NHS England Midlands","Oadby",0,0,3850,3850,0,0,0,0,NA,1,0,0,0,0,0,0,0,0,"March 2025","March-2025-AE-by-provider-cAki3.xls",59
2025-03-01,"NNJ15","NHS England Midlands","Oakham",0,0,406,406,0,0,0,0,NA,1,0,0,0,0,0,0,0,0,"March 2025","March-2025-AE-by-provider-cAki3.xls",59
2025-03-01,"RXK","NHS England Midlands","Sandwell And West Birmingham Hospitals NHS Trust",11907,1150,8616,21673,4955,133,328,5416,0.583858234651885,0.750103815807687,2710,0,0,2710,543,3253,1050,231,"March 2025","March-2025-AE-by-provider-cAki3.xls",59
2025-03-01,"RK5","NHS England Midlands","Sherwood Forest Hospitals NHS Foundation Trust",11777,0,6260,18037,3938,0,540,4478,0.665619427698055,0.751732549758829,3904,0,2,3906,303,4209,542,63,"March 2025","March-2025-AE-by-provider-cAki3.xls",59
2025-03-01,"R1D","NHS England Midlands","Shropshire Community Health NHS Trust",0,0,3251,3251,0,0,6,6,NA,0.998154414026453,0,0,0,0,0,0,0,0,"March 2025","March-2025-AE-by-provider-cAki3.xls",59
2025-03-01,"C83023","NHS England Midlands","Sleaford Medical Group",0,0,540,540,0,0,0,0,NA,1,0,0,0,0,0,0,0,0,"March 2025","March-2025-AE-by-provider-cAki3.xls",59
2025-03-01,"Y02615","NHS England Midlands","South Birmingham GP Walk In Centre",0,0,7113,7113,0,0,0,0,NA,1,0,0,0,0,0,0,0,0,"March 2025","March-2025-AE-by-provider-cAki3.xls",59
2025-03-01,"RJC","NHS England Midlands","South Warwickshire University NHS Foundation Trust",8483,0,378,8861,2732,0,0,2732,0.6779441235412,0.691682654327954,2303,0,0,2303,877,3180,521,47,"March 2025","March-2025-AE-by-provider-cAki3.xls",59
2025-03-01,"NQTE4","NHS England Midlands","Summerfield Urgent Care Centre",0,0,3151,3151,0,0,0,0,NA,1,0,0,0,0,0,0,0,0,"March 2025","March-2025-AE-by-provider-cAki3.xls",59
2025-03-01,"RNA","NHS England Midlands","The Dudley Group NHS Foundation Trust",10115,0,5222,15337,2893,0,99,2992,0.71398912506179,0.804916215687553,3716,0,0,3716,2467,6183,2072,112,"March 2025","March-2025-AE-by-provider-cAki3.xls",59
2025-03-01,"RL1","NHS England Midlands","The Robert Jones And Agnes Hunt Orthopaedic Hospital NHS Foundation Trust",0,0,0,0,0,0,0,0,NA,NA,0,0,0,0,0,0,0,0,"March 2025","March-2025-AE-by-provider-cAki3.xls",59
2025-03-01,"RL4","NHS England Midlands","The Royal Wolverhampton NHS Trust",13055,0,9481,22536,3933,0,214,4147,0.698736116430486,0.815983315583955,5766,0,0,5766,1046,6812,1454,472,"March 2025","March-2025-AE-by-provider-cAki3.xls",59
2025-03-01,"RXW","NHS England Midlands","The Shrewsbury And Telford Hospital NHS Trust",11111,0,2873,13984,6350,0,295,6645,0.428494284942849,0.524814073226545,3147,0,220,3367,2165,5532,1830,1390,"March 2025","March-2025-AE-by-provider-cAki3.xls",59
2025-03-01,"RWD","NHS England Midlands","United Lincolnshire Teaching Hospitals NHS Trust",16558,0,3931,20489,5812,0,417,6229,0.648991424085034,0.695983210503197,4894,0,0,4894,1137,6031,1647,573,"March 2025","March-2025-AE-by-provider-cAki3.xls",59
2025-03-01,"RRK","NHS England Midlands","University Hospitals Birmingham NHS Foundation Trust",34819,357,2126,37302,13817,0,74,13891,0.603176426663603,0.627607098815077,10425,0,0,10425,7034,17459,4549,1690,"March 2025","March-2025-AE-by-provider-cAki3.xls",59
2025-03-01,"RKB","NHS England Midlands","University Hospitals Coventry And Warwickshire NHS Trust",12494,1602,6644,20740,5333,133,297,5763,0.573155114454938,0.722131147540984,1598,31,55,1684,638,2322,110,14,"March 2025","March-2025-AE-by-provider-cAki3.xls",59
2025-03-01,"RTG","NHS England Midlands","University Hospitals Of Derby And Burton NHS Foundation Trust",21365,0,9978,31343,9189,0,3,9192,0.569904048677744,0.706728775165109,4191,0,3,4194,1939,6133,1751,704,"March 2025","March-2025-AE-by-provider-cAki3.xls",59
2025-03-01,"RWE","NHS England Midlands","University Hospitals Of Leicester NHS Trust",22642,2150,0,24792,9943,237,0,10180,0.560860348025793,0.589383672152307,6467,3,0,6470,3646,10116,2508,901,"March 2025","March-2025-AE-by-provider-cAki3.xls",59
2025-03-01,"RJE","NHS England Midlands","University Hospitals Of North Midlands NHS Trust",15475,541,9397,25413,8289,0,712,9001,0.464361873990307,0.645811198992642,5761,0,0,5761,2936,8697,1937,851,"March 2025","March-2025-AE-by-provider-cAki3.xls",59
2025-03-01,"RBK","NHS England Midlands","Walsall Healthcare NHS Trust",9339,0,4711,14050,3356,0,114,3470,0.640646750187386,0.753024911032029,3856,0,0,3856,817,4673,1269,312,"March 2025","March-2025-AE-by-provider-cAki3.xls",59
2025-03-01,"RWP","NHS England Midlands","Worcestershire Acute Hospitals NHS Trust",13805,0,6203,20008,6738,0,71,6809,0.511915972473741,0.65968612554978,2693,0,0,2693,861,3554,1656,731,"March 2025","March-2025-AE-by-provider-cAki3.xls",59
2025-03-01,"RLQ","NHS England Midlands","Wye Valley NHS Trust",6308,1157,158,7623,2803,0,0,2803,0.55564362714014,0.63229699593336,1461,0,0,1461,151,1612,708,293,"March 2025","March-2025-AE-by-provider-cAki3.xls",59
2025-03-01,"RCF","NHS England North East And Yorkshire","Airedale NHS Foundation Trust",6433,232,0,6665,2541,0,0,2541,0.605005440696409,0.618754688672168,1521,0,0,1521,521,2042,663,223,"March 2025","March-2025-AE-by-provider-cAki3.xls",59
2025-03-01,"RFF","NHS England North East And Yorkshire","Barnsley Hospital NHS Foundation Trust",9293,0,0,9293,1838,0,0,1838,0.80221672226407,0.80221672226407,3249,0,0,3249,530,3779,229,0,"March 2025","March-2025-AE-by-provider-cAki3.xls",59
2025-03-01,"RAE","NHS England North East And Yorkshire","Bradford Teaching Hospitals NHS Foundation Trust",9248,1045,3252,13545,2305,0,3,2308,0.750756920415225,0.829605020302695,2612,0,35,2647,1429,4076,784,97,"March 2025","March-2025-AE-by-provider-cAki3.xls",59
2025-03-01,"NNF09","NHS England North East And Yorkshire","Bransholme Health Centre",0,0,3661,3661,0,0,575,575,NA,0.842939087680962,0,0,0,0,0,0,0,0,"March 2025","March-2025-AE-by-provider-cAki3.xls",59
2025-03-01,"NNF16","NHS England North East And Yorkshire","Bridlington Hospital",0,0,1464,1464,0,0,63,63,NA,0.956967213114754,0,0,0,0,0,0,0,0,"March 2025","March-2025-AE-by-provider-cAki3.xls",59
2025-03-01,"RWY","NHS England North East And Yorkshire","Calderdale And Huddersfield NHS Foundation Trust",16307,0,0,16307,2976,0,0,2976,0.817501686392347,0.817501686392347,2750,0,0,2750,209,2959,905,20,"March 2025","March-2025-AE-by-provider-cAki3.xls",59
2025-03-01,"RXP","NHS England North East And Yorkshire","County Durham And Darlington NHS Foundation Trust",13515,0,12233,25748,5213,0,0,5213,0.614280429152793,0.797537672828958,4479,0,0,4479,783,5262,1844,13,"March 2025","March-2025-AE-by-provider-cAki3.xls",59
2025-03-01,"RP5","NHS England North East And Yorkshire","Doncaster And Bassetlaw Teaching Hospitals NHS Foundation Trust",14073,0,4384,18457,4642,0,21,4663,0.67014851133376,0.747358725686731,3831,0,429,4260,1055,5315,1083,118,"March 2025","March-2025-AE-by-provider-cAki3.xls",59
2025-03-01,"NNF94","NHS England North East And Yorkshire","East Riding Community Hospital",0,0,2943,2943,0,0,287,287,NA,0.90248046211349,0,0,0,0,0,0,0,0,"March 2025","March-2025-AE-by-provider-cAki3.xls",59
2025-03-01,"RR7","NHS England North East And Yorkshire","Gateshead Health NHS Foundation Trust",5903,0,4000,9903,2489,0,32,2521,0.578349991529731,0.745430677572453,1598,0,0,1598,52,1650,839,2,"March 2025","March-2025-AE-by-provider-cAki3.xls",59
2025-03-01,"NNFA7","NHS England North East And Yorkshire","Goole & District Hospital",0,0,1680,1680,0,0,20,20,NA,0.988095238095238,0,0,0,0,0,0,0,0,"March 2025","March-2025-AE-by-provider-cAki3.xls",59
2025-03-01,"RCD","NHS England North East And Yorkshire","Harrogate And District NHS Foundation Trust",5491,0,1014,6505,1371,0,1,1372,0.750318703332726,0.789085318985396,1150,0,0,1150,315,1465,409,23,"March 2025","March-2025-AE-by-provider-cAki3.xls",59
2025-03-01,"RWA","NHS England North East And Yorkshire","Hull University Teaching Hospitals NHS Trust",9198,0,5279,14477,5401,0,606,6007,0.412807131985214,0.585065966705809,3486,0,0,3486,2346,5832,1546,536,"March 2025","March-2025-AE-by-provider-cAki3.xls",59
2025-03-01,"RV9","NHS England North East And Yorkshire","Humber Teaching NHS Foundation Trust",0,0,1076,1076,0,0,10,10,NA,0.990706319702602,0,0,0,0,0,0,0,0,"March 2025","March-2025-AE-by-provider-cAki3.xls",59
2025-03-01,"RR8","NHS England North East And Yorkshire","Leeds Teaching Hospitals NHS Trust",18023,741,12822,31586,6494,0,51,6545,0.639682627753426,0.792787944025834,3721,0,0,3721,1180,4901,2015,299,"March 2025","March-2025-AE-by-provider-cAki3.xls",59
2025-03-01,"ARN03","NHS England North East And Yorkshire","Local Care Direct",0,0,2452,2452,0,0,9,9,NA,0.996329526916803,0,0,0,0,0,0,0,0,"March 2025","March-2025-AE-by-provider-cAki3.xls",59
2025-03-01,"RXF","NHS England North East And Yorkshire","Mid Yorkshire Teaching NHS Trust",17228,154,6268,23650,6475,0,510,6985,0.624158346877177,0.704651162790698,3671,0,179,3850,909,4759,2313,277,"March 2025","March-2025-AE-by-provider-cAki3.xls",59
2025-03-01,"RNN","NHS England North East And Yorkshire","North Cumbria Integrated Care NHS Foundation Trust",9237,0,1957,11194,3967,0,25,3992,0.570531557865108,0.643380382347686,2440,0,0,2440,735,3175,1071,482,"March 2025","March-2025-AE-by-provider-cAki3.xls",59
2025-03-01,"RVW","NHS England North East And Yorkshire","North Tees And Hartlepool NHS Foundation Trust",5014,0,11944,16958,2394,0,47,2441,0.52253689668927,0.856056138695601,1715,0,566,2281,2543,4824,172,8,"March 2025","March-2025-AE-by-provider-cAki3.xls",59
2025-03-01,"RJL","NHS England North East And Yorkshire","Northern Lincolnshire And Goole NHS Foundation Trust",9197,0,7778,16975,4766,0,70,4836,0.481787539415027,0.715110456553755,5717,0,0,5717,498,6215,1329,653,"March 2025","March-2025-AE-by-provider-cAki3.xls",59
2025-03-01,"RTF","NHS England North East And Yorkshire","Northumbria Healthcare NHS Foundation Trust",10277,0,13291,23568,2532,0,6,2538,0.753624598618274,0.892311608961303,4278,0,18,4296,473,4769,35,0,"March 2025","March-2025-AE-by-provider-cAki3.xls",59
2025-03-01,"RCU","NHS England North East And Yorkshire","Sheffield Children's NHS Foundation Trust",5181,0,449,5630,531,0,0,531,0.897510133178923,0.905683836589698,1106,0,0,1106,75,1181,7,0,"March 2025","March-2025-AE-by-provider-cAki3.xls",59
2025-03-01,"RHQ","NHS England North East And Yorkshire","Sheffield Teaching Hospitals NHS Foundation Trust",9454,1210,8345,19009,4847,0,266,5113,0.487306960016924,0.731022147403861,3814,0,0,3814,3186,7000,1007,5,"March 2025","March-2025-AE-by-provider-cAki3.xls",59
2025-03-01,"RTR","NHS England North East And Yorkshire","South Tees Hospitals NHS Foundation Trust",7561,0,11168,18729,3994,0,580,4574,0.471762994312922,0.755779806716856,2678,0,127,2805,2448,5253,283,7,"March 2025","March-2025-AE-by-provider-cAki3.xls",59
2025-03-01,"R0B","NHS England North East And Yorkshire","South Tyneside And Sunderland NHS Foundation Trust",12249,1338,7763,21350,5159,25,303,5487,0.578822761041718,0.742997658079625,4487,12,0,4499,1547,6046,318,2,"March 2025","March-2025-AE-by-provider-cAki3.xls",59
2025-03-01,"RXG","NHS England North East And Yorkshire","South West Yorkshire Partnership NHS Foundation Trust",0,0,0,0,0,0,0,0,NA,NA,0,0,0,0,131,131,0,0,"March 2025","March-2025-AE-by-provider-cAki3.xls",59
2025-03-01,"RTD","NHS England North East And Yorkshire","The Newcastle Upon Tyne Hospitals NHS Foundation Trust",12877,1781,6604,21262,4559,215,1,4775,0.645957909450959,0.775420938763992,3769,22,0,3791,2861,6652,562,37,"March 2025","March-2025-AE-by-provider-cAki3.xls",59
2025-03-01,"RFR","NHS England North East And Yorkshire","The Rotherham NHS Foundation Trust",9434,0,0,9434,3256,0,0,3256,0.654865380538478,0.654865380538478,1982,0,0,1982,218,2200,684,35,"March 2025","March-2025-AE-by-provider-cAki3.xls",59
2025-03-01,"AJN","NHS England North East And Yorkshire","Workington Health Limited",0,0,336,336,0,0,0,0,NA,1,0,0,0,0,0,0,0,0,"March 2025","March-2025-AE-by-provider-cAki3.xls",59
2025-03-01,"RCB","NHS England North East And Yorkshire","York And Scarborough Teaching Hospitals NHS Foundation Trust",10854,333,7214,18401,6123,0,302,6425,0.435876174682145,0.650834193793816,4796,0,0,4796,1599,6395,1355,539,"March 2025","March-2025-AE-by-provider-cAki3.xls",59
2025-03-01,"RBS","NHS England North West","Alder Hey Children's NHS Foundation Trust",6446,0,0,6446,1301,0,0,1301,0.798169407384424,0.798169407384424,831,0,0,831,297,1128,4,0,"March 2025","March-2025-AE-by-provider-cAki3.xls",59
2025-03-01,"RXL","NHS England North West","Blackpool Teaching Hospitals NHS Foundation Trust",9382,0,11384,20766,4164,0,71,4235,0.556171392027286,0.796060868727728,2743,0,0,2743,1747,4490,1048,549,"March 2025","March-2025-AE-by-provider-cAki3.xls",59
2025-03-01,"RMC","NHS England North West","Bolton NHS Foundation Trust",8420,0,3912,12332,3342,0,131,3473,0.603087885985748,0.718374959455076,2574,0,116,2690,1023,3713,827,272,"March 2025","March-2025-AE-by-provider-cAki3.xls",59
2025-03-01,"RY2","NHS England North West","Bridgewater Community Healthcare NHS Foundation Trust",0,0,3210,3210,0,0,106,106,NA,0.966978193146417,0,0,0,0,0,0,0,0,"March 2025","March-2025-AE-by-provider-cAki3.xls",59
2025-03-01,"RJR","NHS England North West","Countess Of Chester Hospital NHS Foundation Trust",5250,0,2446,7696,2764,0,358,3122,0.47352380952381,0.594334719334719,1598,0,0,1598,1288,2886,903,650,"March 2025","March-2025-AE-by-provider-cAki3.xls",59
2025-03-01,"RJN","NHS England North West","East Cheshire NHS Trust",4524,0,60,4584,2223,0,0,2223,0.508620689655172,0.515052356020942,754,0,0,754,205,959,602,470,"March 2025","March-2025-AE-by-provider-cAki3.xls",59
2025-03-01,"RXR","NHS England North West","East Lancashire Hospitals NHS Trust",13340,0,11173,24513,4452,0,527,4979,0.666266866566717,0.796883286419451,3876,0,101,3977,1664,5641,1629,1105,"March 2025","March-2025-AE-by-provider-cAki3.xls",59
2025-03-01,"RXN","NHS England North West","Lancashire Teaching Hospitals NHS Foundation Trust",12337,0,3441,15778,4715,0,165,4880,0.617816324876388,0.690708581569274,2420,0,92,2512,1119,3631,1433,418,"March 2025","March-2025-AE-by-provider-cAki3.xls",59
2025-03-01,"RBQ","NHS England North West","Liverpool Heart And Chest Hospital NHS Foundation Trust",0,0,0,0,0,0,0,0,NA,NA,0,0,0,0,170,170,0,0,"March 2025","March-2025-AE-by-provider-cAki3.xls",59
2025-03-01,"REM","NHS England North West","Liverpool University Hospitals NHS Foundation Trust",16276,1842,8129,26247,8068,120,335,8523,0.504300811010076,0.675277174534233,4562,0,0,4562,2461,7023,2957,982,"March 2025","March-2025-AE-by-provider-cAki3.xls",59
2025-03-01,"REP","NHS England North West","Liverpool Women's NHS Foundation Trust",0,1632,0,1632,0,176,0,176,NA,0.892156862745098,0,118,0,118,14,132,0,0,"March 2025","March-2025-AE-by-provider-cAki3.xls",59
2025-03-01,"R0A","NHS England North West","Manchester University NHS Foundation Trust",28984,3542,12838,45364,11116,154,565,11835,0.616478056858957,0.739110307733004,5886,148,165,6199,429,6628,2972,101,"March 2025","March-2025-AE-by-provider-cAki3.xls",59
2025-03-01,"RBN","NHS England North West","Mersey And West Lancashire Teaching Hospitals NHS Trust",18310,0,7558,25868,6506,0,147,6653,0.644675040961223,0.742809648987166,8282,0,0,8282,679,8961,1015,363,"March 2025","March-2025-AE-by-provider-cAki3.xls",59
2025-03-01,"RW4","NHS England North West","Mersey Care NHS Foundation Trust",0,0,14217,14217,0,0,405,405,NA,0.971512977421397,0,0,0,0,44,44,0,0,"March 2025","March-2025-AE-by-provider-cAki3.xls",59
2025-03-01,"RBT","NHS England North West","Mid Cheshire Hospitals NHS Foundation Trust",7136,0,3331,10467,4139,0,69,4208,0.419983183856502,0.597974586796599,2236,0,0,2236,1348,3584,1145,541,"March 2025","March-2025-AE-by-provider-cAki3.xls",59
2025-03-01,"Y02532","NHS England North West","Miriam Minor Emergency",0,0,1709,1709,0,0,0,0,NA,1,0,0,0,0,0,0,0,0,"March 2025","March-2025-AE-by-provider-cAki3.xls",59
2025-03-01,"RM3","NHS England North West","Northern Care Alliance NHS Foundation Trust",25828,0,8886,34714,10445,0,401,10846,0.595593929069227,0.687561214495593,7203,0,298,7501,2067,9568,2367,1306,"March 2025","March-2025-AE-by-provider-cAki3.xls",59
2025-03-01,"NV693","NHS England North West","Rossendale Miu & Ooh",0,0,1122,1122,0,0,1,1,NA,0.999108734402852,0,0,0,0,0,0,0,0,"March 2025","March-2025-AE-by-provider-cAki3.xls",59
2025-03-01,"NQT5F","NHS England North West","Skelmersdale Walk In Centre",0,0,1730,1730,0,0,6,6,NA,0.996531791907514,0,0,0,0,0,0,0,0,"March 2025","March-2025-AE-by-provider-cAki3.xls",59
2025-03-01,"RWJ","NHS England North West","Stockport NHS Foundation Trust",8527,0,2574,11101,3358,0,85,3443,0.606192095696024,0.689847761462931,2843,0,82,2925,956,3881,1093,292,"March 2025","March-2025-AE-by-provider-cAki3.xls",59
2025-03-01,"RMP","NHS England North West","Tameside And Glossop Integrated Care NHS Foundation Trust",9204,0,3112,12316,3813,0,20,3833,0.585723598435463,0.688778824293602,1654,0,0,1654,253,1907,695,146,"March 2025","March-2025-AE-by-provider-cAki3.xls",59
2025-03-01,"RBV","NHS England North West","The Christie NHS Foundation Trust",0,0,0,0,0,0,0,0,NA,NA,0,0,0,0,821,821,0,0,"March 2025","March-2025-AE-by-provider-cAki3.xls",59
2025-03-01,"RET","NHS England North West","The Walton Centre NHS Foundation Trust",0,0,0,0,0,0,0,0,NA,NA,0,0,0,0,182,182,0,0,"March 2025","March-2025-AE-by-provider-cAki3.xls",59
2025-03-01,"RTX","NHS England North West","University Hospitals Of Morecambe Bay NHS Foundation Trust",9620,0,4537,14157,3812,0,128,3940,0.603742203742204,0.721692448965176,3127,0,28,3155,1062,4217,1279,544,"March 2025","March-2025-AE-by-provider-cAki3.xls",59
2025-03-01,"RWW","NHS England North West","Warrington And Halton Teaching Hospitals NHS Foundation Trust",7272,0,3351,10623,3655,0,160,3815,0.497387238723872,0.640873576202579,1807,0,0,1807,131,1938,1408,680,"March 2025","March-2025-AE-by-provider-cAki3.xls",59
2025-03-01,"RY7","NHS England North West","Wirral Community Health And Care NHS Foundation Trust",0,0,4551,4551,0,0,402,402,NA,0.911667765326302,0,0,0,0,0,0,0,0,"March 2025","March-2025-AE-by-provider-cAki3.xls",59
2025-03-01,"RBL","NHS England North West","Wirral University Teaching Hospital NHS Foundation Trust",7845,0,3510,11355,4141,0,158,4299,0.47214786488209,0.621400264200793,2155,0,0,2155,1605,3760,1305,893,"March 2025","March-2025-AE-by-provider-cAki3.xls",59
2025-03-01,"RRF","NHS England North West","Wrightington, Wigan And Leigh NHS Foundation Trust",6924,0,5866,12790,3509,0,109,3618,0.493212016175621,0.717122752150117,2391,0,0,2391,661,3052,1621,475,"March 2025","March-2025-AE-by-provider-cAki3.xls",59
2025-03-01,"RTK","NHS England South East","Ashford And St Peter's Hospitals NHS Foundation Trust",10757,0,0,10757,3695,0,0,3695,0.656502742400297,0.656502742400297,2884,0,0,2884,678,3562,759,231,"March 2025","March-2025-AE-by-provider-cAki3.xls",59
2025-03-01,"NTV0B","NHS England South East","Ashford Walk-In-Centre",0,0,2374,2374,0,0,23,23,NA,0.990311710193766,0,0,0,0,0,0,0,0,"March 2025","March-2025-AE-by-provider-cAki3.xls",59
2025-03-01,"RWX","NHS England South East","Berkshire Healthcare NHS Foundation Trust",0,0,1479,1479,0,0,8,8,NA,0.994590939824206,0,0,19,19,0,19,0,0,"March 2025","March-2025-AE-by-provider-cAki3.xls",59
2025-03-01,"Y02676","NHS England South East","Brighton Station Health Centre",0,0,2040,2040,0,0,0,0,NA,1,0,0,0,0,0,0,0,0,"March 2025","March-2025-AE-by-provider-cAki3.xls",59
2025-03-01,"RXQ","NHS England South East","Buckinghamshire Healthcare NHS Trust",11146,1232,3622,16000,3293,0,89,3382,0.704557688856989,0.788625,4044,677,0,4721,2216,6937,505,260,"March 2025","March-2025-AE-by-provider-cAki3.xls",59
2025-03-01,"RN7","NHS England South East","Dartford And Gravesham NHS Trust",11705,0,4168,15873,3694,0,17,3711,0.684408372490389,0.766206766206766,3244,0,0,3244,458,3702,953,407,"March 2025","March-2025-AE-by-provider-cAki3.xls",59
2025-03-01,"Y00751","NHS England South East","East Berks Primary Care Ooh(Wam)",0,0,0,0,0,0,0,0,NA,NA,0,0,0,0,0,0,0,0,"March 2025","March-2025-AE-by-provider-cAki3.xls",59
2025-03-01,"RVV","NHS England South East","East Kent Hospitals University NHS Foundation Trust",12820,0,13288,26108,6228,0,414,6642,0.514196567862715,0.745595219855983,2819,0,528,3347,549,3896,1666,1326,"March 2025","March-2025-AE-by-provider-cAki3.xls",59
2025-03-01,"RXC","NHS England South East","East Sussex Healthcare NHS Trust",10281,0,4593,14874,4198,0,100,4298,0.59167396167688,0.711039397606562,3004,0,0,3004,501,3505,280,92,"March 2025","March-2025-AE-by-provider-cAki3.xls",59
2025-03-01,"NDJ","NHS England South East","First Community Health And Care Cic",0,0,2464,2464,0,0,0,0,NA,1,0,0,0,0,0,0,0,0,"March 2025","March-2025-AE-by-provider-cAki3.xls",59
2025-03-01,"RDU","NHS England South East","Frimley Health NHS Foundation Trust",22632,945,13202,36779,9616,1,306,9923,0.575114881583598,0.730199298512738,6243,0,0,6243,120,6363,2051,437,"March 2025","March-2025-AE-by-provider-cAki3.xls",59
2025-03-01,"RW1","NHS England South East","Hampshire And Isle Of Wight Healthcare NHS Foundation Trust",0,0,3122,3122,0,0,64,64,NA,0.979500320307495,0,0,0,0,140,140,0,0,"March 2025","March-2025-AE-by-provider-cAki3.xls",59
2025-03-01,"RN5","NHS England South East","Hampshire Hospitals NHS Foundation Trust",11387,73,3630,15090,4962,0,150,5112,0.56423992271889,0.661232604373757,4215,9,36,4260,1388,5648,351,52,"March 2025","March-2025-AE-by-provider-cAki3.xls",59
2025-03-01,"R1F","NHS England South East","Isle Of Wight NHS Trust",4290,329,1438,6057,1983,0,0,1983,0.537762237762238,0.672610203070827,1287,0,0,1287,88,1375,488,186,"March 2025","March-2025-AE-by-provider-cAki3.xls",59
2025-03-01,"RYY","NHS England South East","Kent Community Health NHS Foundation Trust",0,0,9690,9690,0,0,32,32,NA,0.996697626418989,0,0,0,0,0,0,0,0,"March 2025","March-2025-AE-by-provider-cAki3.xls",59
2025-03-01,"RWF","NHS England South East","Maidstone And Tunbridge Wells NHS Trust",19127,0,2591,21718,3207,0,26,3233,0.832331259476133,0.851137305460908,5241,0,0,5241,979,6220,818,25,"March 2025","March-2025-AE-by-provider-cAki3.xls",59
2025-03-01,"RPA","NHS England South East","Medway NHS Foundation Trust",9419,0,8156,17575,3220,0,747,3967,0.658137806561206,0.774281650071124,1903,0,0,1903,493,2396,1039,688,"March 2025","March-2025-AE-by-provider-cAki3.xls",59
2025-03-01,"RNU","NHS England South East","Oxford Health NHS Foundation Trust",0,0,3656,3656,0,0,419,419,NA,0.885393873085339,0,0,0,0,0,0,0,0,"March 2025","March-2025-AE-by-provider-cAki3.xls",59
2025-03-01,"RTH","NHS England South East","Oxford University Hospitals NHS Foundation Trust",14558,1830,2199,18587,5855,0,10,5865,0.597815634015662,0.684456878463442,4670,109,10,4789,4539,9328,771,3,"March 2025","March-2025-AE-by-provider-cAki3.xls",59
2025-03-01,"AQN04","NHS England South East","Phl Lymington Utc",0,0,3129,3129,0,0,16,16,NA,0.994886545222116,0,0,0,0,0,0,0,0,"March 2025","March-2025-AE-by-provider-cAki3.xls",59
2025-03-01,"RHU","NHS England South East","Portsmouth Hospitals University National Health Service Trust",12464,838,4097,17399,5130,13,81,5224,0.588414634146341,0.699752859359733,3172,0,0,3172,2611,5783,1664,348,"March 2025","March-2025-AE-by-provider-cAki3.xls",59
2025-03-01,"NTP11","NHS England South East","Practice Plus Group Hospital - Southampton",0,0,5772,5772,0,0,350,350,NA,0.939362439362439,0,0,0,0,0,0,0,0,"March 2025","March-2025-AE-by-provider-cAki3.xls",59
2025-03-01,"NTPAD","NHS England South East","Practice Plus Group Surgical Centre - St Marys Portsmouth",0,0,5950,5950,0,0,147,147,NA,0.975294117647059,0,0,0,0,0,0,0,0,"March 2025","March-2025-AE-by-provider-cAki3.xls",59
2025-03-01,"RPC","NHS England South East","Queen Victoria Hospital NHS Foundation Trust",0,0,1400,1400,0,0,6,6,NA,0.995714285714286,0,0,3,3,493,496,0,0,"March 2025","March-2025-AE-by-provider-cAki3.xls",59
2025-03-01,"Y07709","NHS England South East","Reading Urgent Care Centre",0,0,2020,2020,0,0,0,0,NA,1,0,0,0,0,0,0,0,0,"March 2025","March-2025-AE-by-provider-cAki3.xls",59
2025-03-01,"RHW","NHS England South East","Royal Berkshire NHS Foundation Trust",13201,2367,2157,17725,5215,21,0,5236,0.604954170138626,0.70459802538787,2255,2,0,2257,423,2680,763,33,"March 2025","March-2025-AE-by-provider-cAki3.xls",59
2025-03-01,"RA2","NHS England South East","Royal Surrey County Hospital NHS Foundation Trust",7780,0,1662,9442,2280,0,1,2281,0.70694087403599,0.758419826307985,2583,0,0,2583,1108,3691,269,2,"March 2025","March-2025-AE-by-provider-cAki3.xls",59
2025-03-01,"NQT51","NHS England South East","Station Plaza Health Centre",0,0,1024,1024,0,0,0,0,NA,1,0,0,0,0,0,0,0,0,"March 2025","March-2025-AE-by-provider-cAki3.xls",59
2025-03-01,"RTP","NHS England South East","Surrey And Sussex Healthcare NHS Trust",10472,0,0,10472,3739,0,0,3739,0.642952635599694,0.642952635599694,3223,0,0,3223,923,4146,1175,688,"March 2025","March-2025-AE-by-provider-cAki3.xls",59
2025-03-01,"RDR","NHS England South East","Sussex Community NHS Foundation Trust",0,0,12570,12570,0,0,121,121,NA,0.990373906125696,0,0,0,0,0,0,0,0,"March 2025","March-2025-AE-by-provider-cAki3.xls",59
2025-03-01,"RHM","NHS England South East","University Hospital Southampton NHS Foundation Trust",11967,1243,0,13210,5121,144,0,5265,0.572073201303585,0.601438304314913,3886,9,0,3895,1645,5540,638,10,"March 2025","March-2025-AE-by-provider-cAki3.xls",59
2025-03-01,"RYR","NHS England South East","University Hospitals Sussex NHS Foundation Trust",28432,1483,2704,32619,10506,39,235,10780,0.630486775464266,0.669517765719366,8684,23,89,8796,1565,10361,1729,912,"March 2025","March-2025-AE-by-provider-cAki3.xls",59
2025-03-01,"ACH01","NHS England South East","Whitstable Medical Practice",0,0,5414,5414,0,0,0,0,NA,1,0,0,0,0,0,0,0,0,"March 2025","March-2025-AE-by-provider-cAki3.xls",59
2025-03-01,"NTV0W","NHS England South East","Woking Walk In Centre",0,0,2683,2683,0,0,12,12,NA,0.995527394707417,0,0,0,0,0,0,0,0,"March 2025","March-2025-AE-by-provider-cAki3.xls",59
2025-03-01,"RJ8","NHS England South West","Cornwall Partnership NHS Foundation Trust",0,0,0,0,0,0,0,0,NA,NA,0,0,16,16,74,90,0,0,"March 2025","March-2025-AE-by-provider-cAki3.xls",59
2025-03-01,"RBD","NHS England South West","Dorset County Hospital NHS Foundation Trust",4514,0,4529,9043,1407,0,9,1416,0.688303057155516,0.843414795974787,1881,0,0,1881,610,2491,248,66,"March 2025","March-2025-AE-by-provider-cAki3.xls",59
2025-03-01,"RDY","NHS England South West","Dorset Healthcare University NHS Foundation Trust",0,0,0,0,0,0,0,0,NA,NA,0,0,1,1,0,1,0,0,"March 2025","March-2025-AE-by-provider-cAki3.xls",59
2025-03-01,"RTQ","NHS England South West","Gloucestershire Health And Care NHS Foundation Trust",0,0,8527,8527,0,0,126,126,NA,0.985223407998123,0,0,0,0,32,32,0,0,"March 2025","March-2025-AE-by-provider-cAki3.xls",59
2025-03-01,"RTE","NHS England South West","Gloucestershire Hospitals NHS Foundation Trust",13769,0,0,13769,5406,0,0,5406,0.607378894618346,0.607378894618346,2713,0,0,2713,2398,5111,836,459,"March 2025","March-2025-AE-by-provider-cAki3.xls",59
2025-03-01,"RN3","NHS England South West","Great Western Hospitals NHS Foundation Trust",5662,0,5652,11314,2928,0,458,3386,0.482868244436595,0.700724765776914,2450,0,0,2450,1391,3841,870,323,"March 2025","March-2025-AE-by-provider-cAki3.xls",59
2025-03-01,"RVJ","NHS England South West","North Bristol NHS Trust",9215,0,0,9215,3568,0,0,3568,0.612805208898535,0.612805208898535,2661,0,0,2661,2225,4886,945,407,"March 2025","March-2025-AE-by-provider-cAki3.xls",59
2025-03-01,"L83087","NHS England South West","Okehampton Medical Centre",0,0,87,87,0,0,0,0,NA,1,0,0,0,0,0,0,0,0,"March 2025","March-2025-AE-by-provider-cAki3.xls",59
2025-03-01,"NQT5H","NHS England South West","Paulton Memorial Hospital",0,0,913,913,0,0,5,5,NA,0.994523548740416,0,0,0,0,0,0,0,0,"March 2025","March-2025-AE-by-provider-cAki3.xls",59
2025-03-01,"REF","NHS England South West","Royal Cornwall Hospitals NHS Trust",6629,0,12512,19141,3494,0,709,4203,0.472922009352844,0.780418995872734,2613,0,51,2664,1130,3794,1177,423,"March 2025","March-2025-AE-by-provider-cAki3.xls",59
2025-03-01,"RH8","NHS England South West","Royal Devon University Healthcare NHS Foundation Trust",13959,0,4333,18292,6050,0,25,6075,0.566587864460205,0.667887601137109,3437,0,0,3437,1943,5380,1688,215,"March 2025","March-2025-AE-by-provider-cAki3.xls",59
2025-03-01,"RD1","NHS England South West","Royal United Hospitals Bath NHS Foundation Trust",8762,0,0,8762,3632,0,0,3632,0.585482766491669,0.585482766491669,2580,0,3,2583,1844,4427,992,163,"March 2025","March-2025-AE-by-provider-cAki3.xls",59
2025-03-01,"RNZ","NHS England South West","Salisbury NHS Foundation Trust",4905,312,1873,7090,2057,0,0,2057,0.580632008154944,0.709873060648801,1242,0,0,1242,1090,2332,510,43,"March 2025","March-2025-AE-by-provider-cAki3.xls",59
2025-03-01,"NLX","NHS England South West","Sirona Care & Health",0,0,9729,9729,0,0,434,434,NA,0.955391098776853,0,0,0,0,0,0,0,0,"March 2025","March-2025-AE-by-provider-cAki3.xls",59
2025-03-01,"RH5","NHS England South West","Somerset NHS Foundation Trust",13097,0,9956,23053,6180,0,229,6409,0.528136214400244,0.721988461371622,3118,0,0,3118,1840,4958,508,86,"March 2025","March-2025-AE-by-provider-cAki3.xls",59
2025-03-01,"RYF","NHS England South West","South Western Ambulance Service NHS Foundation Trust",0,0,1939,1939,0,0,16,16,NA,0.991748323878288,0,0,0,0,0,0,0,0,"March 2025","March-2025-AE-by-provider-cAki3.xls",59
2025-03-01,"AAH","NHS England South West","Tetbury Hospital Trust Ltd",0,0,707,707,0,0,0,0,NA,1,0,0,0,0,0,0,0,0,"March 2025","March-2025-AE-by-provider-cAki3.xls",59
2025-03-01,"RA9","NHS England South West","Torbay And South Devon NHS Foundation Trust",7055,0,3512,10567,3137,0,50,3187,0.555350815024805,0.698400681366518,2305,0,0,2305,1183,3488,330,45,"March 2025","March-2025-AE-by-provider-cAki3.xls",59
2025-03-01,"RA7","NHS England South West","University Hospitals Bristol And Weston NHS Foundation Trust",16099,2536,0,18635,5748,207,0,5955,0.642959190011802,0.680440032197478,5388,5,0,5393,1558,6951,1695,534,"March 2025","March-2025-AE-by-provider-cAki3.xls",59
2025-03-01,"R0D","NHS England South West","University Hospitals Dorset NHS Foundation Trust",13702,0,5527,19229,5364,0,0,5364,0.608524303021457,0.721046336262936,4209,4,0,4213,2508,6721,1374,288,"March 2025","March-2025-AE-by-provider-cAki3.xls",59
2025-03-01,"RK9","NHS England South West","University Hospitals Plymouth NHS Trust",9353,130,5705,15188,5004,0,193,5197,0.464984496952849,0.657821964708981,2827,0,0,2827,1502,4329,1146,735,"March 2025","March-2025-AE-by-provider-cAki3.xls",59
2025-02-01,"RC9","NHS England East Of England","Bedfordshire Hospitals NHS Foundation Trust",14688,0,8999,23687,6486,0,0,6486,0.558415032679739,0.726178916705366,4304,0,0,4304,2198,6502,88,8,"February 2025","February-2025-AE-by-provider-1zaQ6.xls",31
2025-02-01,"RGT","NHS England East Of England","Cambridge University Hospitals NHS Foundation Trust",9923,0,5529,15452,4774,0,51,4825,0.518895495313917,0.687742687030805,2413,0,21,2434,432,2866,1036,630,"February 2025","February-2025-AE-by-provider-1zaQ6.xls",31
2025-02-01,"RWH","NHS England East Of England","East And North Hertfordshire NHS Trust",8035,0,6880,14915,4478,0,127,4605,0.442688238954574,0.691250419041234,2493,0,5,2498,226,2724,521,267,"February 2025","February-2025-AE-by-provider-1zaQ6.xls",31
2025-02-01,"RDE","NHS England East Of England","East Suffolk And North Essex NHS Foundation Trust",12248,0,14066,26314,6074,0,374,6448,0.504082299150882,0.754959337234932,5855,0,359,6214,1040,7254,1771,778,"February 2025","February-2025-AE-by-provider-1zaQ6.xls",31
2025-02-01,"RY4","NHS England East Of England","Hertfordshire Community NHS Trust",0,0,1019,1019,0,0,15,15,NA,0.985279685966634,0,0,0,0,0,0,0,0,"February 2025","February-2025-AE-by-provider-1zaQ6.xls",31
2025-02-01,"DT301","NHS England East Of England","Herts Urgent Care (Ascots Lane)",0,0,1895,1895,0,0,52,52,NA,0.972559366754617,0,0,0,0,0,0,0,0,"February 2025","February-2025-AE-by-provider-1zaQ6.xls",31
2025-02-01,"RGP","NHS England East Of England","James Paget University Hospitals NHS Foundation Trust",6286,0,1389,7675,2714,0,0,2714,0.568246897868279,0.646384364820847,1459,0,0,1459,466,1925,966,450,"February 2025","February-2025-AE-by-provider-1zaQ6.xls",31
2025-02-01,"RAJ","NHS England East Of England","Mid And South Essex NHS Foundation Trust",26920,0,3566,30486,9739,0,229,9968,0.638224368499257,0.673030243390409,7902,0,174,8076,1290,9366,2872,275,"February 2025","February-2025-AE-by-provider-1zaQ6.xls",31
2025-02-01,"RD8","NHS England East Of England","Milton Keynes University Hospital NHS Foundation Trust",8073,0,4805,12878,3159,0,256,3415,0.608695652173913,0.734819071284361,2153,0,0,2153,426,2579,735,0,"February 2025","February-2025-AE-by-provider-1zaQ6.xls",31
2025-02-01,"RM1","NHS England East Of England","Norfolk And Norwich University Hospitals NHS Foundation Trust",10792,0,7401,18193,3503,0,0,3503,0.675407709414381,0.807453416149068,2292,0,0,2292,1500,3792,1196,294,"February 2025","February-2025-AE-by-provider-1zaQ6.xls",31
2025-02-01,"RGN","NHS England East Of England","North West Anglia NHS Foundation Trust",13531,0,4376,17907,5849,0,172,6021,0.567733353041165,0.663762774334059,3302,0,37,3339,1499,4838,1181,792,"February 2025","February-2025-AE-by-provider-1zaQ6.xls",31
2025-02-01,"Y02428","NHS England East Of England","Putnoe Walk In Centre",0,0,3152,3152,0,0,0,0,NA,1,0,0,0,0,0,0,0,0,"February 2025","February-2025-AE-by-provider-1zaQ6.xls",31
2025-02-01,"RQW","NHS England East Of England","The Princess Alexandra Hospital NHS Trust",7328,0,2583,9911,3762,0,0,3762,0.486626637554585,0.620421753607103,1587,0,0,1587,241,1828,517,91,"February 2025","February-2025-AE-by-provider-1zaQ6.xls",31
2025-02-01,"RCX","NHS England East Of England","The Queen Elizabeth Hospital, King's Lynn, NHS Foundation Trust",6037,0,1069,7106,2929,0,0,2929,0.514825244326652,0.587813115676893,2108,0,0,2108,367,2475,397,127,"February 2025","February-2025-AE-by-provider-1zaQ6.xls",31
2025-02-01,"RWG","NHS England East Of England","West Hertfordshire Teaching Hospitals NHS Trust",7727,0,7263,14990,2887,0,137,3024,0.626375048531125,0.798265510340227,3978,0,0,3978,571,4549,833,17,"February 2025","February-2025-AE-by-provider-1zaQ6.xls",31
2025-02-01,"RGR","NHS England East Of England","West Suffolk NHS Foundation Trust",6728,0,653,7381,2428,0,0,2428,0.639120095124851,0.671047283565912,1557,0,0,1557,334,1891,849,489,"February 2025","February-2025-AE-by-provider-1zaQ6.xls",31
2025-02-01,"G0Q0L","NHS England London","Barking Hospital Utc",0,0,2673,2673,0,0,13,13,NA,0.995136550692106,0,0,0,0,0,0,0,0,"February 2025","February-2025-AE-by-provider-1zaQ6.xls",31
2025-02-01,"RF4","NHS England London","Barking, Havering And Redbridge University Hospitals NHS Trust",12433,2272,13441,28146,6017,366,143,6526,0.516046006595351,0.768137568393377,7312,0,0,7312,437,7749,1431,816,"February 2025","February-2025-AE-by-provider-1zaQ6.xls",31
2025-02-01,"R1H","NHS England London","Barts Health NHS Trust",22906,837,16926,40669,10470,24,1686,12180,0.542914520213045,0.70050898718926,4110,0,33,4143,1051,5194,1987,962,"February 2025","February-2025-AE-by-provider-1zaQ6.xls",31
2025-02-01,"AD913","NHS England London","Beckenham Beacon Ucc",0,0,3574,3574,0,0,96,96,NA,0.973139339675434,0,0,0,0,0,0,0,0,"February 2025","February-2025-AE-by-provider-1zaQ6.xls",31
2025-02-01,"RYX","NHS England London","Central London Community Healthcare NHS Trust",0,0,11689,11689,0,0,264,264,NA,0.977414663358713,0,0,0,0,0,0,0,0,"February 2025","February-2025-AE-by-provider-1zaQ6.xls",31
2025-02-01,"RQM","NHS England London","Chelsea And Westminster Hospital NHS Foundation Trust",18231,0,5691,23922,6091,0,103,6194,0.665898743897757,0.741075160939721,2563,0,0,2563,353,2916,1269,43,"February 2025","February-2025-AE-by-provider-1zaQ6.xls",31
2025-02-01,"RJ6","NHS England London","Croydon Health Services NHS Trust",11931,0,4589,16520,4204,0,0,4204,0.647640600117341,0.745520581113802,1139,0,0,1139,125,1264,732,446,"February 2025","February-2025-AE-by-provider-1zaQ6.xls",31
2025-02-01,"RVR","NHS England London","Epsom And St Helier University Hospitals NHS Trust",10156,356,1265,11777,3063,0,72,3135,0.698404883812525,0.733803175681413,1793,4,0,1797,123,1920,895,652,"February 2025","February-2025-AE-by-provider-1zaQ6.xls",31
2025-02-01,"RJ1","NHS England London","Guy's And St Thomas' NHS Foundation Trust",9085,702,6171,15958,3570,20,137,3727,0.607044578976335,0.766449429753102,1883,0,0,1883,232,2115,159,19,"February 2025","February-2025-AE-by-provider-1zaQ6.xls",31
2025-02-01,"K6K0R","NHS England London","Harold Wood Polyclinic Utc",0,0,2654,2654,0,0,7,7,NA,0.997362471740769,0,0,0,0,0,0,0,0,"February 2025","February-2025-AE-by-provider-1zaQ6.xls",31
2025-02-01,"RQX","NHS England London","Homerton Healthcare NHS Foundation Trust",10056,0,0,10056,2077,0,0,2077,0.793456642800318,0.793456642800318,1660,0,0,1660,306,1966,302,24,"February 2025","February-2025-AE-by-provider-1zaQ6.xls",31
2025-02-01,"RYJ","NHS England London","Imperial College Healthcare NHS Trust",11067,3367,6900,21334,4982,39,361,5382,0.54983283636035,0.747726633542702,3265,0,0,3265,1042,4307,981,364,"February 2025","February-2025-AE-by-provider-1zaQ6.xls",31
2025-02-01,"RJZ","NHS England London","King's College Hospital NHS Foundation Trust",14163,0,9273,23436,6657,0,171,6828,0.529972463461131,0.708653353814644,3307,0,0,3307,329,3636,2473,1069,"February 2025","February-2025-AE-by-provider-1zaQ6.xls",31
2025-02-01,"RAX","NHS England London","Kingston And Richmond NHS Foundation Trust",6478,0,7589,14067,3131,0,182,3313,0.516671812287743,0.764484253927632,2145,0,198,2343,291,2634,685,446,"February 2025","February-2025-AE-by-provider-1zaQ6.xls",31
2025-02-01,"RJ2","NHS England London","Lewisham And Greenwich NHS Trust",12884,0,10368,23252,6709,0,1259,7968,0.479276622167029,0.657319800447273,4406,0,0,4406,1159,5565,1831,750,"February 2025","February-2025-AE-by-provider-1zaQ6.xls",31
2025-02-01,"R1K","NHS England London","London North West University Healthcare NHS Trust",12788,0,13626,26414,6764,0,131,6895,0.471066624960901,0.73896418565912,5893,0,0,5893,339,6232,1246,547,"February 2025","February-2025-AE-by-provider-1zaQ6.xls",31
2025-02-01,"RP6","NHS England London","Moorfields Eye Hospital NHS Foundation Trust",0,5007,0,5007,0,65,0,65,NA,0.987018174555622,0,0,0,0,186,186,0,0,"February 2025","February-2025-AE-by-provider-1zaQ6.xls",31
2025-02-01,"RAT","NHS England London","North East London NHS Foundation Trust",0,0,1349,1349,0,0,37,37,NA,0.972572275759822,0,0,0,0,0,0,0,0,"February 2025","February-2025-AE-by-provider-1zaQ6.xls",31
2025-02-01,"RAL","NHS England London","Royal Free London NHS Foundation Trust",23359,456,14710,38525,9352,7,940,10299,0.599640395564879,0.732667099286178,4254,0,51,4305,687,4992,2796,1691,"February 2025","February-2025-AE-by-provider-1zaQ6.xls",31
2025-02-01,"RAN","NHS England London","Royal National Orthopaedic Hospital NHS Trust",0,0,0,0,0,0,0,0,NA,NA,0,0,0,0,28,28,0,0,"February 2025","February-2025-AE-by-provider-1zaQ6.xls",31
2025-02-01,"RJ7","NHS England London","St George's University Hospitals NHS Foundation Trust",8557,0,2886,11443,2189,0,0,2189,0.744186046511628,0.808704011185878,2380,0,0,2380,672,3052,1191,738,"February 2025","February-2025-AE-by-provider-1zaQ6.xls",31
2025-02-01,"RAS","NHS England London","The Hillingdon Hospitals NHS Foundation Trust",5687,0,5922,11609,3208,0,90,3298,0.435906453314577,0.715910069773452,1715,0,0,1715,51,1766,718,94,"February 2025","February-2025-AE-by-provider-1zaQ6.xls",31
2025-02-01,"Y03218","NHS England London","The Pinn Unregistered Wic",0,0,695,695,0,0,0,0,NA,1,0,0,0,0,0,0,0,0,"February 2025","February-2025-AE-by-provider-1zaQ6.xls",31
2025-02-01,"RRV","NHS England London","University College London Hospitals NHS Foundation Trust",12348,0,0,12348,3195,0,0,3195,0.741253644314869,0.741253644314869,1231,0,0,1231,252,1483,512,203,"February 2025","February-2025-AE-by-provider-1zaQ6.xls",31
2025-02-01,"Y02147","NHS England London","Urgent Care Centre (Qms)",0,0,7981,7981,0,0,118,118,NA,0.985214885352713,0,0,0,0,0,0,0,0,"February 2025","February-2025-AE-by-provider-1zaQ6.xls",31
2025-02-01,"RKE","NHS England London","Whittington Health NHS Trust",8215,0,0,8215,2725,0,0,2725,0.668289713937918,0.668289713937918,1055,0,0,1055,39,1094,539,324,"February 2025","February-2025-AE-by-provider-1zaQ6.xls",31
2025-02-01,"NL7","NHS England Midlands","Assura Vertis Urgent Care Centres (Birmingham)",0,0,3811,3811,0,0,0,0,NA,1,0,0,0,0,0,0,0,0,"February 2025","February-2025-AE-by-provider-1zaQ6.xls",31
2025-02-01,"8J094","NHS England Midlands","Badger Ltd",0,0,1300,1300,0,0,0,0,NA,1,0,0,0,0,0,0,0,0,"February 2025","February-2025-AE-by-provider-1zaQ6.xls",31
2025-02-01,"RQ3","NHS England Midlands","Birmingham Women's And Children's NHS Foundation Trust",4700,0,0,4700,982,0,0,982,0.791063829787234,0.791063829787234,979,0,0,979,134,1113,6,6,"February 2025","February-2025-AE-by-provider-1zaQ6.xls",31
2025-02-01,"RFS","NHS England Midlands","Chesterfield Royal Hospital NHS Foundation Trust",6330,0,5650,11980,3169,0,308,3477,0.499368088467615,0.709766277128548,2491,0,208,2699,611,3310,992,151,"February 2025","February-2025-AE-by-provider-1zaQ6.xls",31
2025-02-01,"RYG","NHS England Midlands","Coventry And Warwickshire Partnership NHS Trust",0,0,0,0,0,0,0,0,NA,NA,0,0,3,3,79,82,0,0,"February 2025","February-2025-AE-by-provider-1zaQ6.xls",31
2025-02-01,"RY8","NHS England Midlands","Derbyshire Community Health Services NHS Foundation Trust",0,0,7816,7816,0,0,71,71,NA,0.990916069600819,0,0,0,0,0,0,0,0,"February 2025","February-2025-AE-by-provider-1zaQ6.xls",31
2025-02-01,"NNJ","NHS England Midlands","Dhu Health Care C.I.C",0,0,1821,1821,0,0,1,1,NA,0.99945085118067,0,0,0,0,0,0,0,0,"February 2025","February-2025-AE-by-provider-1zaQ6.xls",31
2025-02-01,"Y03007","NHS England Midlands","Erdington GP Health & Wellbeing Wic",0,0,1637,1637,0,0,0,0,NA,1,0,0,0,0,0,0,0,0,"February 2025","February-2025-AE-by-provider-1zaQ6.xls",31
2025-02-01,"RLT","NHS England Midlands","George Eliot Hospital NHS Trust",6292,0,1466,7758,2296,0,62,2358,0.635092180546726,0.696055684454756,982,0,0,982,1,983,708,392,"February 2025","February-2025-AE-by-provider-1zaQ6.xls",31
2025-02-01,"RNQ","NHS England Midlands","Kettering General Hospital NHS Foundation Trust",9253,0,7965,17218,3468,0,128,3596,0.6252026369826,0.791148797769776,1724,0,0,1724,239,1963,1280,0,"February 2025","February-2025-AE-by-provider-1zaQ6.xls",31
2025-02-01,"C82038","NHS England Midlands","Latham House Medical Practice",0,0,278,278,0,0,0,0,NA,1,0,0,0,0,0,0,0,0,"February 2025","February-2025-AE-by-provider-1zaQ6.xls",31
2025-02-01,"RY5","NHS England Midlands","Lincolnshire Community Health Services NHS Trust",0,0,7310,7310,0,0,168,168,NA,0.977017783857729,0,0,0,0,0,0,0,0,"February 2025","February-2025-AE-by-provider-1zaQ6.xls",31
2025-02-01,"NNJ0H","NHS England Midlands","Llr Ea - The Merlyn Vaz Health & Social Care Centre",0,0,2142,2142,0,0,1,1,NA,0.99953314659197,0,0,0,0,0,0,0,0,"February 2025","February-2025-AE-by-provider-1zaQ6.xls",31
2025-02-01,"NNJ07","NHS England Midlands","Loughborough Urgent Care Centre",0,0,7290,7290,0,0,32,32,NA,0.995610425240055,0,0,0,0,0,0,0,0,"February 2025","February-2025-AE-by-provider-1zaQ6.xls",31
2025-02-01,"NNJ12","NHS England Midlands","Market Harborough",0,0,578,578,0,0,0,0,NA,1,0,0,0,0,0,0,0,0,"February 2025","February-2025-AE-by-provider-1zaQ6.xls",31
2025-02-01,"C82009","NHS England Midlands","Market Harborough Med.Ctr",0,0,281,281,0,0,0,0,NA,1,0,0,0,0,0,0,0,0,"February 2025","February-2025-AE-by-provider-1zaQ6.xls",31
2025-02-01,"NNJ13","NHS England Midlands","Melton Mowbray",0,0,459,459,0,0,0,0,NA,1,0,0,0,0,0,0,0,0,"February 2025","February-2025-AE-by-provider-1zaQ6.xls",31
2025-02-01,"RNS","NHS England Midlands","Northampton General Hospital NHS Trust",9133,515,2333,11981,3783,11,229,4023,0.585787802474543,0.664218345714047,2110,0,0,2110,767,2877,1237,659,"February 2025","February-2025-AE-by-provider-1zaQ6.xls",31
2025-02-01,"NR3","NHS England Midlands","Nottingham Citycare Partnership",0,0,5411,5411,0,0,483,483,NA,0.910737386804657,0,0,0,0,0,0,0,0,"February 2025","February-2025-AE-by-provider-1zaQ6.xls",31
2025-02-01,"RX1","NHS England Midlands","Nottingham University Hospitals NHS Trust",14519,1625,882,17026,7643,70,301,8014,0.473586335147049,0.529308116997533,4242,0,0,4242,3931,8173,723,509,"February 2025","February-2025-AE-by-provider-1zaQ6.xls",31
2025-02-01,"NNJ14","NHS England Midlands","Oadby",0,0,3452,3452,0,0,2,2,NA,0.999420625724218,0,0,0,0,0,0,0,0,"February 2025","February-2025-AE-by-provider-1zaQ6.xls",31
2025-02-01,"NNJ15","NHS England Midlands","Oakham",0,0,413,413,0,0,0,0,NA,1,0,0,0,0,0,0,0,0,"February 2025","February-2025-AE-by-provider-1zaQ6.xls",31
2025-02-01,"RXK","NHS England Midlands","Sandwell And West Birmingham Hospitals NHS Trust",10630,1051,7976,19657,4845,149,13,5007,0.544214487300094,0.745281579081243,2253,0,0,2253,483,2736,1053,354,"February 2025","February-2025-AE-by-provider-1zaQ6.xls",31
2025-02-01,"RK5","NHS England Midlands","Sherwood Forest Hospitals NHS Foundation Trust",9867,0,5335,15202,4345,0,497,4842,0.559643255295429,0.681489277726615,3531,0,0,3531,283,3814,823,170,"February 2025","February-2025-AE-by-provider-1zaQ6.xls",31
2025-02-01,"R1D","NHS England Midlands","Shropshire Community Health NHS Trust",0,0,2653,2653,0,0,0,0,NA,1,0,0,0,0,0,0,0,0,"February 2025","February-2025-AE-by-provider-1zaQ6.xls",31
2025-02-01,"C83023","NHS England Midlands","Sleaford Medical Group",0,0,490,490,0,0,0,0,NA,1,0,0,0,0,0,0,0,0,"February 2025","February-2025-AE-by-provider-1zaQ6.xls",31
2025-02-01,"Y02615","NHS England Midlands","South Birmingham GP Walk In Centre",0,0,6625,6625,0,0,0,0,NA,1,0,0,0,0,0,0,0,0,"February 2025","February-2025-AE-by-provider-1zaQ6.xls",31
2025-02-01,"RJC","NHS England Midlands","South Warwickshire University NHS Foundation Trust",7206,0,337,7543,2448,0,0,2448,0.660283097418818,0.675460692032348,2053,0,0,2053,788,2841,419,36,"February 2025","February-2025-AE-by-provider-1zaQ6.xls",31
2025-02-01,"NQTE4","NHS England Midlands","Summerfield Urgent Care Centre",0,0,2969,2969,0,0,0,0,NA,1,0,0,0,0,0,0,0,0,"February 2025","February-2025-AE-by-provider-1zaQ6.xls",31
2025-02-01,"RNA","NHS England Midlands","The Dudley Group NHS Foundation Trust",8415,0,4713,13128,2555,0,239,2794,0.696375519904932,0.787172455819622,3464,0,0,3464,2258,5722,1956,28,"February 2025","February-2025-AE-by-provider-1zaQ6.xls",31
2025-02-01,"RL1","NHS England Midlands","The Robert Jones And Agnes Hunt Orthopaedic Hospital NHS Foundation Trust",0,0,0,0,0,0,0,0,NA,NA,0,0,0,0,27,27,0,0,"February 2025","February-2025-AE-by-provider-1zaQ6.xls",31
2025-02-01,"RL4","NHS England Midlands","The Royal Wolverhampton NHS Trust",11364,0,8414,19778,3431,0,146,3577,0.698081661386836,0.819142481545151,5182,0,0,5182,930,6112,1300,567,"February 2025","February-2025-AE-by-provider-1zaQ6.xls",31
2025-02-01,"RXW","NHS England Midlands","The Shrewsbury And Telford Hospital NHS Trust",9128,0,2405,11533,5301,0,167,5468,0.419259421560035,0.525882250932108,2699,0,199,2898,2030,4928,1465,1130,"February 2025","February-2025-AE-by-provider-1zaQ6.xls",31
2025-02-01,"RWD","NHS England Midlands","United Lincolnshire Teaching Hospitals NHS Trust",14759,0,3331,18090,6039,0,598,6637,0.59082593671658,0.633112216694306,4170,0,0,4170,1118,5288,1873,1070,"February 2025","February-2025-AE-by-provider-1zaQ6.xls",31
2025-02-01,"RRK","NHS England Midlands","University Hospitals Birmingham NHS Foundation Trust",31058,282,1801,33141,12580,0,7,12587,0.594951381286625,0.620198545608159,9332,0,0,9332,6424,15756,4028,1657,"February 2025","February-2025-AE-by-provider-1zaQ6.xls",31
2025-02-01,"RKB","NHS England Midlands","University Hospitals Coventry And Warwickshire NHS Trust",10786,1500,5717,18003,5345,119,288,5752,0.504450213239384,0.68049769482864,1592,42,46,1680,587,2267,102,25,"February 2025","February-2025-AE-by-provider-1zaQ6.xls",31
2025-02-01,"RTG","NHS England Midlands","University Hospitals Of Derby And Burton NHS Foundation Trust",18262,0,8367,26629,8317,0,7,8324,0.544573431168547,0.687408464456044,3737,0,1,3738,1787,5525,1767,862,"February 2025","February-2025-AE-by-provider-1zaQ6.xls",31
2025-02-01,"RWE","NHS England Midlands","University Hospitals Of Leicester NHS Trust",19778,1807,0,21585,8352,112,0,8464,0.577712609970675,0.607875839703498,5806,2,0,5808,3425,9233,2224,921,"February 2025","February-2025-AE-by-provider-1zaQ6.xls",31
2025-02-01,"RJE","NHS England Midlands","University Hospitals Of North Midlands NHS Trust",13122,478,8258,21858,7333,0,366,7699,0.441167504953513,0.64777198279806,4837,0,0,4837,2954,7791,1911,1275,"February 2025","February-2025-AE-by-provider-1zaQ6.xls",31
2025-02-01,"RBK","NHS England Midlands","Walsall Healthcare NHS Trust",8291,0,4135,12426,3215,0,113,3328,0.612230129055602,0.732174472879446,3483,0,0,3483,707,4190,1531,358,"February 2025","February-2025-AE-by-provider-1zaQ6.xls",31
2025-02-01,"RWP","NHS England Midlands","Worcestershire Acute Hospitals NHS Trust",11492,0,4772,16264,5476,0,27,5503,0.523494604942569,0.661645351697,2289,0,0,2289,843,3132,1560,669,"February 2025","February-2025-AE-by-provider-1zaQ6.xls",31
2025-02-01,"RLQ","NHS England Midlands","Wye Valley NHS Trust",5368,1036,86,6490,2214,0,0,2214,0.587555886736215,0.658859784283513,1304,0,0,1304,117,1421,631,219,"February 2025","February-2025-AE-by-provider-1zaQ6.xls",31
2025-02-01,"RCF","NHS England North East And Yorkshire","Airedale NHS Foundation Trust",5645,217,0,5862,2298,0,0,2298,0.592914083259522,0.607983623336745,1442,0,0,1442,488,1930,608,162,"February 2025","February-2025-AE-by-provider-1zaQ6.xls",31
2025-02-01,"RFF","NHS England North East And Yorkshire","Barnsley Hospital NHS Foundation Trust",7895,0,0,7895,3573,0,0,3573,0.54743508549715,0.54743508549715,2644,0,0,2644,466,3110,577,5,"February 2025","February-2025-AE-by-provider-1zaQ6.xls",31
2025-02-01,"RAE","NHS England North East And Yorkshire","Bradford Teaching Hospitals NHS Foundation Trust",8651,881,2733,12265,2191,0,2,2193,0.746734481562825,0.821198532409295,2311,0,18,2329,1393,3722,698,124,"February 2025","February-2025-AE-by-provider-1zaQ6.xls",31
2025-02-01,"NNF09","NHS England North East And Yorkshire","Bransholme Health Centre",0,0,3281,3281,0,0,403,403,NA,0.877171594026211,0,0,0,0,0,0,0,0,"February 2025","February-2025-AE-by-provider-1zaQ6.xls",31
2025-02-01,"NNF16","NHS England North East And Yorkshire","Bridlington Hospital",0,0,1248,1248,0,0,18,18,NA,0.985576923076923,0,0,0,0,0,0,0,0,"February 2025","February-2025-AE-by-provider-1zaQ6.xls",31
2025-02-01,"RWY","NHS England North East And Yorkshire","Calderdale And Huddersfield NHS Foundation Trust",14096,0,0,14096,4471,0,0,4471,0.682817820658343,0.682817820658343,2486,0,0,2486,189,2675,1192,48,"February 2025","February-2025-AE-by-provider-1zaQ6.xls",31
2025-02-01,"RXP","NHS England North East And Yorkshire","County Durham And Darlington NHS Foundation Trust",11724,0,10751,22475,4853,0,0,4853,0.586062777209144,0.784071190211346,4006,0,0,4006,741,4747,1780,16,"February 2025","February-2025-AE-by-provider-1zaQ6.xls",31
2025-02-01,"RP5","NHS England North East And Yorkshire","Doncaster And Bassetlaw Teaching Hospitals NHS Foundation Trust",12394,0,3649,16043,4429,0,1,4430,0.642649669194772,0.723867107149536,3496,0,217,3713,1025,4738,1151,124,"February 2025","February-2025-AE-by-provider-1zaQ6.xls",31
2025-02-01,"NNF94","NHS England North East And Yorkshire","East Riding Community Hospital",0,0,2515,2515,0,0,221,221,NA,0.912127236580517,0,0,0,0,0,0,0,0,"February 2025","February-2025-AE-by-provider-1zaQ6.xls",31
2025-02-01,"RR7","NHS England North East And Yorkshire","Gateshead Health NHS Foundation Trust",5264,0,3143,8407,2195,0,28,2223,0.583016717325228,0.735577494944689,1453,0,0,1453,41,1494,822,0,"February 2025","February-2025-AE-by-provider-1zaQ6.xls",31
2025-02-01,"NNFA7","NHS England North East And Yorkshire","Goole & District Hospital",0,0,1361,1361,0,0,10,10,NA,0.992652461425422,0,0,0,0,0,0,0,0,"February 2025","February-2025-AE-by-provider-1zaQ6.xls",31
2025-02-01,"RCD","NHS England North East And Yorkshire","Harrogate And District NHS Foundation Trust",4725,0,808,5533,1444,0,1,1445,0.694391534391534,0.7388396891379,1026,0,0,1026,285,1311,216,10,"February 2025","February-2025-AE-by-provider-1zaQ6.xls",31
2025-02-01,"RWA","NHS England North East And Yorkshire","Hull University Teaching Hospitals NHS Trust",8151,0,4608,12759,4986,0,401,5387,0.388295914611704,0.577788227917548,3249,0,0,3249,2011,5260,1315,391,"February 2025","February-2025-AE-by-provider-1zaQ6.xls",31
2025-02-01,"RV9","NHS England North East And Yorkshire","Humber Teaching NHS Foundation Trust",0,0,998,998,0,0,0,0,NA,1,0,0,0,0,0,0,0,0,"February 2025","February-2025-AE-by-provider-1zaQ6.xls",31
2025-02-01,"RR8","NHS England North East And Yorkshire","Leeds Teaching Hospitals NHS Trust",16148,660,11286,28094,7362,0,220,7582,0.544092147634382,0.730120310386559,3376,0,0,3376,1133,4509,2092,581,"February 2025","February-2025-AE-by-provider-1zaQ6.xls",31
2025-02-01,"ARN03","NHS England North East And Yorkshire","Local Care Direct",0,0,2323,2323,0,0,9,9,NA,0.996125699526474,0,0,0,0,0,0,0,0,"February 2025","February-2025-AE-by-provider-1zaQ6.xls",31
2025-02-01,"RXF","NHS England North East And Yorkshire","Mid Yorkshire Teaching NHS Trust",14924,119,5296,20339,6477,0,387,6864,0.566001072098633,0.662520281233099,3169,0,125,3294,792,4086,2500,458,"February 2025","February-2025-AE-by-provider-1zaQ6.xls",31
2025-02-01,"RNN","NHS England North East And Yorkshire","North Cumbria Integrated Care NHS Foundation Trust",8088,0,1657,9745,3776,0,15,3791,0.533135509396637,0.610979989738327,2205,0,0,2205,661,2866,1210,502,"February 2025","February-2025-AE-by-provider-1zaQ6.xls",31
2025-02-01,"RVW","NHS England North East And Yorkshire","North Tees And Hartlepool NHS Foundation Trust",4546,0,10231,14777,2115,0,28,2143,0.534755829300484,0.85497732963389,1581,0,408,1989,2085,4074,157,1,"February 2025","February-2025-AE-by-provider-1zaQ6.xls",31
2025-02-01,"RJL","NHS England North East And Yorkshire","Northern Lincolnshire And Goole NHS Foundation Trust",8126,0,6677,14803,4234,0,43,4277,0.478956436130938,0.711072079983787,5129,0,0,5129,421,5550,1306,736,"February 2025","February-2025-AE-by-provider-1zaQ6.xls",31
2025-02-01,"RTF","NHS England North East And Yorkshire","Northumbria Healthcare NHS Foundation Trust",8770,0,10454,19224,2769,0,4,2773,0.684264538198404,0.855753225135248,3496,0,16,3512,315,3827,119,3,"February 2025","February-2025-AE-by-provider-1zaQ6.xls",31
2025-02-01,"RCU","NHS England North East And Yorkshire","Sheffield Children's NHS Foundation Trust",4164,0,481,4645,375,0,0,375,0.909942363112392,0.919268030139935,984,0,0,984,80,1064,7,0,"February 2025","February-2025-AE-by-provider-1zaQ6.xls",31
2025-02-01,"RHQ","NHS England North East And Yorkshire","Sheffield Teaching Hospitals NHS Foundation Trust",8293,1110,7817,17220,4398,0,305,4703,0.469673218376944,0.726887340301974,3372,0,0,3372,2795,6167,951,8,"February 2025","February-2025-AE-by-provider-1zaQ6.xls",31
2025-02-01,"RTR","NHS England North East And Yorkshire","South Tees Hospitals NHS Foundation Trust",6667,0,9558,16225,3433,0,559,3992,0.485075746212689,0.753959938366718,2411,0,115,2526,2151,4677,303,11,"February 2025","February-2025-AE-by-provider-1zaQ6.xls",31
2025-02-01,"R0B","NHS England North East And Yorkshire","South Tyneside And Sunderland NHS Foundation Trust",10716,1135,6359,18210,5555,22,254,5831,0.481616274729377,0.679791323448655,3877,19,0,3896,1332,5228,743,3,"February 2025","February-2025-AE-by-provider-1zaQ6.xls",31
2025-02-01,"RXG","NHS England North East And Yorkshire","South West Yorkshire Partnership NHS Foundation Trust",0,0,0,0,0,0,0,0,NA,NA,0,0,0,0,116,116,0,0,"February 2025","February-2025-AE-by-provider-1zaQ6.xls",31
2025-02-01,"RTD","NHS England North East And Yorkshire","The Newcastle Upon Tyne Hospitals NHS Foundation Trust",11293,1530,5945,18768,4249,110,5,4364,0.623749225183742,0.767476555839727,3415,17,0,3432,2611,6043,579,35,"February 2025","February-2025-AE-by-provider-1zaQ6.xls",31
2025-02-01,"RFR","NHS England North East And Yorkshire","The Rotherham NHS Foundation Trust",8181,0,0,8181,2971,0,0,2971,0.63684146192397,0.63684146192397,1742,0,0,1742,200,1942,759,55,"February 2025","February-2025-AE-by-provider-1zaQ6.xls",31
2025-02-01,"AJN","NHS England North East And Yorkshire","Workington Health Limited",0,0,279,279,0,0,0,0,NA,1,0,0,0,0,0,0,0,0,"February 2025","February-2025-AE-by-provider-1zaQ6.xls",31
2025-02-01,"RCB","NHS England North East And Yorkshire","York And Scarborough Teaching Hospitals NHS Foundation Trust",9502,321,6536,16359,5345,0,191,5536,0.437486844874763,0.661593006907513,4251,0,0,4251,1416,5667,1137,433,"February 2025","February-2025-AE-by-provider-1zaQ6.xls",31
2025-02-01,"RBS","NHS England North West","Alder Hey Children's NHS Foundation Trust",5570,0,0,5570,1182,0,0,1182,0.787791741472172,0.787791741472172,816,0,0,816,272,1088,1,0,"February 2025","February-2025-AE-by-provider-1zaQ6.xls",31
2025-02-01,"RXL","NHS England North West","Blackpool Teaching Hospitals NHS Foundation Trust",8161,0,10176,18337,3745,0,116,3861,0.541110158068864,0.789442111577685,2405,0,0,2405,1471,3876,956,579,"February 2025","February-2025-AE-by-provider-1zaQ6.xls",31
2025-02-01,"RMC","NHS England North West","Bolton NHS Foundation Trust",7374,0,3286,10660,3690,0,178,3868,0.499593165174939,0.637148217636022,2256,0,124,2380,956,3336,940,454,"February 2025","February-2025-AE-by-provider-1zaQ6.xls",31
2025-02-01,"RY2","NHS England North West","Bridgewater Community Healthcare NHS Foundation Trust",0,0,2857,2857,0,0,162,162,NA,0.943297164858243,0,0,0,0,0,0,0,0,"February 2025","February-2025-AE-by-provider-1zaQ6.xls",31
2025-02-01,"RJR","NHS England North West","Countess Of Chester Hospital NHS Foundation Trust",4540,0,1979,6519,2307,0,178,2485,0.491850220264317,0.618806565424145,1613,0,0,1613,1171,2784,855,660,"February 2025","February-2025-AE-by-provider-1zaQ6.xls",31
2025-02-01,"RJN","NHS England North West","East Cheshire NHS Trust",3912,0,66,3978,1970,0,0,1970,0.49642126789366,0.504776269482152,749,0,0,749,181,930,438,266,"February 2025","February-2025-AE-by-provider-1zaQ6.xls",31
2025-02-01,"RXR","NHS England North West","East Lancashire Hospitals NHS Trust",11973,0,9497,21470,4297,0,648,4945,0.641109162281801,0.769678621332091,3543,0,93,3636,1588,5224,1471,1050,"February 2025","February-2025-AE-by-provider-1zaQ6.xls",31
2025-02-01,"RXN","NHS England North West","Lancashire Teaching Hospitals NHS Foundation Trust",10708,0,3216,13924,4305,0,165,4470,0.597964138961524,0.678971559896581,2100,0,84,2184,1103,3287,1346,455,"February 2025","February-2025-AE-by-provider-1zaQ6.xls",31
2025-02-01,"RBQ","NHS England North West","Liverpool Heart And Chest Hospital NHS Foundation Trust",0,0,0,0,0,0,0,0,NA,NA,0,0,0,0,157,157,0,0,"February 2025","February-2025-AE-by-provider-1zaQ6.xls",31
2025-02-01,"REM","NHS England North West","Liverpool University Hospitals NHS Foundation Trust",14442,1623,7572,23637,6999,71,240,7310,0.515371832156211,0.690739095485891,4155,0,0,4155,2206,6361,2885,1016,"February 2025","February-2025-AE-by-provider-1zaQ6.xls",31
2025-02-01,"REP","NHS England North West","Liverpool Women's NHS Foundation Trust",0,1530,0,1530,0,178,0,178,NA,0.883660130718954,0,97,0,97,17,114,0,0,"February 2025","February-2025-AE-by-provider-1zaQ6.xls",31
2025-02-01,"R0A","NHS England North West","Manchester University NHS Foundation Trust",25755,3203,11173,40131,11533,128,581,12242,0.552203455639682,0.694949041887817,5040,135,147,5322,384,5706,3975,211,"February 2025","February-2025-AE-by-provider-1zaQ6.xls",31
2025-02-01,"RBN","NHS England North West","Mersey And West Lancashire Teaching Hospitals NHS Trust",15726,0,6647,22373,5614,0,133,5747,0.643011573190894,0.743127877352165,7357,0,0,7357,549,7906,899,400,"February 2025","February-2025-AE-by-provider-1zaQ6.xls",31
2025-02-01,"RW4","NHS England North West","Mersey Care NHS Foundation Trust",0,0,13023,13023,0,0,273,273,NA,0.979037088228519,0,0,0,0,42,42,0,0,"February 2025","February-2025-AE-by-provider-1zaQ6.xls",31
2025-02-01,"RBT","NHS England North West","Mid Cheshire Hospitals NHS Foundation Trust",6236,0,2671,8907,3576,0,66,3642,0.426555484284798,0.591108117211182,1995,0,0,1995,1161,3156,1012,475,"February 2025","February-2025-AE-by-provider-1zaQ6.xls",31
2025-02-01,"Y02532","NHS England North West","Miriam Minor Emergency",0,0,1561,1561,0,0,0,0,NA,1,0,0,0,0,0,0,0,0,"February 2025","February-2025-AE-by-provider-1zaQ6.xls",31
2025-02-01,"RM3","NHS England North West","Northern Care Alliance NHS Foundation Trust",22781,0,8419,31200,9896,0,408,10304,0.565602914709626,0.66974358974359,6566,0,314,6880,1919,8799,2161,1005,"February 2025","February-2025-AE-by-provider-1zaQ6.xls",31
2025-02-01,"NV693","NHS England North West","Rossendale Miu & Ooh",0,0,866,866,0,0,1,1,NA,0.998845265588914,0,0,0,0,0,0,0,0,"February 2025","February-2025-AE-by-provider-1zaQ6.xls",31
2025-02-01,"NQT5F","NHS England North West","Skelmersdale Walk In Centre",0,0,1730,1730,0,0,6,6,NA,0.996531791907514,0,0,0,0,0,0,0,0,"February 2025","February-2025-AE-by-provider-1zaQ6.xls",31
2025-02-01,"RWJ","NHS England North West","Stockport NHS Foundation Trust",7148,0,1035,8183,2447,0,52,2499,0.657666480134303,0.694610778443114,2525,0,61,2586,822,3408,964,240,"February 2025","February-2025-AE-by-provider-1zaQ6.xls",31
2025-02-01,"RMP","NHS England North West","Tameside And Glossop Integrated Care NHS Foundation Trust",7988,0,2924,10912,3540,0,53,3593,0.556835252879319,0.670729472140763,1470,0,0,1470,234,1704,867,327,"February 2025","February-2025-AE-by-provider-1zaQ6.xls",31
2025-02-01,"RBV","NHS England North West","The Christie NHS Foundation Trust",0,0,0,0,0,0,0,0,NA,NA,0,0,0,0,722,722,0,0,"February 2025","February-2025-AE-by-provider-1zaQ6.xls",31
2025-02-01,"RET","NHS England North West","The Walton Centre NHS Foundation Trust",0,0,0,0,0,0,0,0,NA,NA,0,0,0,0,174,174,0,0,"February 2025","February-2025-AE-by-provider-1zaQ6.xls",31
2025-02-01,"RTX","NHS England North West","University Hospitals Of Morecambe Bay NHS Foundation Trust",8177,0,3739,11916,2718,0,99,2817,0.66760425583955,0.763595166163142,2905,0,18,2923,856,3779,940,382,"February 2025","February-2025-AE-by-provider-1zaQ6.xls",31
2025-02-01,"RWW","NHS England North West","Warrington And Halton Teaching Hospitals NHS Foundation Trust",6372,0,2747,9119,3361,0,66,3427,0.472536095417451,0.624191249040465,1542,0,0,1542,145,1687,1440,908,"February 2025","February-2025-AE-by-provider-1zaQ6.xls",31
2025-02-01,"RY7","NHS England North West","Wirral Community Health And Care NHS Foundation Trust",0,0,3965,3965,0,0,191,191,NA,0.951828499369483,0,0,0,0,0,0,0,0,"February 2025","February-2025-AE-by-provider-1zaQ6.xls",31
2025-02-01,"RBL","NHS England North West","Wirral University Teaching Hospital NHS Foundation Trust",6626,0,3002,9628,3677,0,29,3706,0.445064895864775,0.615081013710012,1781,0,0,1781,1567,3348,1217,871,"February 2025","February-2025-AE-by-provider-1zaQ6.xls",31
2025-02-01,"RRF","NHS England North West","Wrightington, Wigan And Leigh NHS Foundation Trust",6655,0,4556,11211,3542,0,73,3615,0.467768595041322,0.677548835964678,1981,0,0,1981,622,2603,1455,440,"February 2025","February-2025-AE-by-provider-1zaQ6.xls",31
2025-02-01,"RTK","NHS England South East","Ashford And St Peter's Hospitals NHS Foundation Trust",9225,0,0,9225,3070,0,0,3070,0.667208672086721,0.667208672086721,2499,0,0,2499,584,3083,753,289,"February 2025","February-2025-AE-by-provider-1zaQ6.xls",31
2025-02-01,"NTV0B","NHS England South East","Ashford Walk-In-Centre",0,0,2144,2144,0,0,93,93,NA,0.956623134328358,0,0,0,0,0,0,0,0,"February 2025","February-2025-AE-by-provider-1zaQ6.xls",31
2025-02-01,"RWX","NHS England South East","Berkshire Healthcare NHS Foundation Trust",0,0,1173,1173,0,0,9,9,NA,0.9923273657289,0,0,23,23,0,23,0,0,"February 2025","February-2025-AE-by-provider-1zaQ6.xls",31
2025-02-01,"Y02676","NHS England South East","Brighton Station Health Centre",0,0,1819,1819,0,0,0,0,NA,1,0,0,0,0,0,0,0,0,"February 2025","February-2025-AE-by-provider-1zaQ6.xls",31
2025-02-01,"RXQ","NHS England South East","Buckinghamshire Healthcare NHS Trust",9887,1090,3215,14192,3010,0,86,3096,0.695559826034186,0.78184892897407,3892,768,0,4660,2063,6723,579,348,"February 2025","February-2025-AE-by-provider-1zaQ6.xls",31
2025-02-01,"RN7","NHS England South East","Dartford And Gravesham NHS Trust",10568,0,3847,14415,3504,0,16,3520,0.668433005299016,0.755809920221991,3014,0,0,3014,402,3416,981,497,"February 2025","February-2025-AE-by-provider-1zaQ6.xls",31
2025-02-01,"Y00751","NHS England South East","East Berks Primary Care Ooh(Wam)",0,0,0,0,0,0,0,0,NA,NA,0,0,0,0,0,0,0,0,"February 2025","February-2025-AE-by-provider-1zaQ6.xls",31
2025-02-01,"RVV","NHS England South East","East Kent Hospitals University NHS Foundation Trust",11788,0,11781,23569,5878,0,441,6319,0.501357312521208,0.731893589036446,2602,0,476,3078,477,3555,1523,1177,"February 2025","February-2025-AE-by-provider-1zaQ6.xls",31
2025-02-01,"RXC","NHS England South East","East Sussex Healthcare NHS Trust",8773,0,3887,12660,3415,0,115,3530,0.610737490026217,0.721169036334913,2799,0,0,2799,496,3295,295,76,"February 2025","February-2025-AE-by-provider-1zaQ6.xls",31
2025-02-01,"NDJ","NHS England South East","First Community Health And Care Cic",0,0,1941,1941,0,0,0,0,NA,1,0,0,0,0,0,0,0,0,"February 2025","February-2025-AE-by-provider-1zaQ6.xls",31
2025-02-01,"RDU","NHS England South East","Frimley Health NHS Foundation Trust",19788,936,11742,32466,8753,1,297,9051,0.557661208813422,0.721216041397154,5632,0,0,5632,100,5732,1677,472,"February 2025","February-2025-AE-by-provider-1zaQ6.xls",31
2025-02-01,"RW1","NHS England South East","Hampshire And Isle Of Wight Healthcare NHS Foundation Trust",0,0,2518,2518,0,0,37,37,NA,0.985305798252581,0,0,0,0,119,119,0,0,"February 2025","February-2025-AE-by-provider-1zaQ6.xls",31
2025-02-01,"RN5","NHS England South East","Hampshire Hospitals NHS Foundation Trust",9858,86,2765,12709,4319,0,96,4415,0.561878677216474,0.652608387756708,3947,10,23,3980,1250,5230,549,147,"February 2025","February-2025-AE-by-provider-1zaQ6.xls",31
2025-02-01,"R1F","NHS England South East","Isle Of Wight NHS Trust",4158,318,1293,5769,1686,0,0,1686,0.594516594516595,0.707748309932397,1161,0,0,1161,103,1264,275,68,"February 2025","February-2025-AE-by-provider-1zaQ6.xls",31
2025-02-01,"RYY","NHS England South East","Kent Community Health NHS Foundation Trust",0,0,2368,2368,0,0,15,15,NA,0.99366554054054,0,0,0,0,0,0,0,0,"February 2025","February-2025-AE-by-provider-1zaQ6.xls",31
2025-02-01,"RWF","NHS England South East","Maidstone And Tunbridge Wells NHS Trust",17683,0,2205,19888,3461,0,15,3476,0.804275292653961,0.825221238938053,4950,0,0,4950,914,5864,1006,189,"February 2025","February-2025-AE-by-provider-1zaQ6.xls",31
2025-02-01,"RPA","NHS England South East","Medway NHS Foundation Trust",7971,0,7341,15312,2814,0,623,3437,0.646970267218668,0.7755355276907,1577,0,0,1577,459,2036,976,707,"February 2025","February-2025-AE-by-provider-1zaQ6.xls",31
2025-02-01,"RNU","NHS England South East","Oxford Health NHS Foundation Trust",0,0,3103,3103,0,0,270,270,NA,0.912987431517886,0,0,0,0,0,0,0,0,"February 2025","February-2025-AE-by-provider-1zaQ6.xls",31
2025-02-01,"RTH","NHS England South East","Oxford University Hospitals NHS Foundation Trust",12741,1621,2228,16590,4849,0,2,4851,0.61941762812966,0.707594936708861,3945,102,6,4053,4035,8088,836,0,"February 2025","February-2025-AE-by-provider-1zaQ6.xls",31
2025-02-01,"AQN04","NHS England South East","Phl Lymington Utc",0,0,2559,2559,0,0,1,1,NA,0.999609222352481,0,0,0,0,0,0,0,0,"February 2025","February-2025-AE-by-provider-1zaQ6.xls",31
2025-02-01,"RHU","NHS England South East","Portsmouth Hospitals University National Health Service Trust",11079,850,3368,15297,4719,9,80,4808,0.57405903059843,0.685690004576061,2887,0,0,2887,2536,5423,1473,346,"February 2025","February-2025-AE-by-provider-1zaQ6.xls",31
2025-02-01,"NTP11","NHS England South East","Practice Plus Group Hospital - Southampton",0,0,4752,4752,0,0,260,260,NA,0.945286195286195,0,0,0,0,0,0,0,0,"February 2025","February-2025-AE-by-provider-1zaQ6.xls",31
2025-02-01,"NTPAD","NHS England South East","Practice Plus Group Surgical Centre - St Marys Portsmouth",0,0,5253,5253,0,0,115,115,NA,0.97810774795355,0,0,0,0,0,0,0,0,"February 2025","February-2025-AE-by-provider-1zaQ6.xls",31
2025-02-01,"RPC","NHS England South East","Queen Victoria Hospital NHS Foundation Trust",0,0,1197,1197,0,0,6,6,NA,0.994987468671679,0,0,3,3,471,474,0,0,"February 2025","February-2025-AE-by-provider-1zaQ6.xls",31
2025-02-01,"Y07709","NHS England South East","Reading Urgent Care Centre",0,0,1843,1843,0,0,0,0,NA,1,0,0,0,0,0,0,0,0,"February 2025","February-2025-AE-by-provider-1zaQ6.xls",31
2025-02-01,"RHW","NHS England South East","Royal Berkshire NHS Foundation Trust",10312,2279,2057,14648,4047,15,0,4062,0.607544608223429,0.722692517749863,2192,1,0,2193,405,2598,540,12,"February 2025","February-2025-AE-by-provider-1zaQ6.xls",31
2025-02-01,"RA2","NHS England South East","Royal Surrey County Hospital NHS Foundation Trust",6905,0,1262,8167,2037,0,0,2037,0.704996379435192,0.750581608913922,2342,0,0,2342,1039,3381,313,1,"February 2025","February-2025-AE-by-provider-1zaQ6.xls",31
2025-02-01,"NQT51","NHS England South East","Station Plaza Health Centre",0,0,1079,1079,0,0,0,0,NA,1,0,0,0,0,0,0,0,0,"February 2025","February-2025-AE-by-provider-1zaQ6.xls",31
2025-02-01,"RTP","NHS England South East","Surrey And Sussex Healthcare NHS Trust",9094,0,0,9094,3108,0,0,3108,0.658236199692105,0.658236199692105,2785,0,0,2785,874,3659,1020,661,"February 2025","February-2025-AE-by-provider-1zaQ6.xls",31
2025-02-01,"RDR","NHS England South East","Sussex Community NHS Foundation Trust",0,0,10491,10491,0,0,101,101,NA,0.990372700409875,0,0,0,0,0,0,0,0,"February 2025","February-2025-AE-by-provider-1zaQ6.xls",31
2025-02-01,"RHM","NHS England South East","University Hospital Southampton NHS Foundation Trust",11083,1122,0,12205,5037,159,0,5196,0.545520166020031,0.57427283900041,3568,17,0,3585,1465,5050,492,11,"February 2025","February-2025-AE-by-provider-1zaQ6.xls",31
2025-02-01,"RYR","NHS England South East","University Hospitals Sussex NHS Foundation Trust",25089,1239,1860,28188,9535,31,151,9717,0.619952967435928,0.655278842060451,7732,26,56,7814,1395,9209,1761,962,"February 2025","February-2025-AE-by-provider-1zaQ6.xls",31
2025-02-01,"ACH01","NHS England South East","Whitstable Medical Practice",0,0,4995,4995,0,0,0,0,NA,1,0,0,0,0,0,0,0,0,"February 2025","February-2025-AE-by-provider-1zaQ6.xls",31
2025-02-01,"NTV0W","NHS England South East","Woking Walk In Centre",0,0,2412,2412,0,0,36,36,NA,0.985074626865672,0,0,0,0,0,0,0,0,"February 2025","February-2025-AE-by-provider-1zaQ6.xls",31
2025-02-01,"RJ8","NHS England South West","Cornwall Partnership NHS Foundation Trust",0,0,0,0,0,0,0,0,NA,NA,0,0,7,7,61,68,0,0,"February 2025","February-2025-AE-by-provider-1zaQ6.xls",31
2025-02-01,"RBD","NHS England South West","Dorset County Hospital NHS Foundation Trust",3812,0,3557,7369,1610,0,6,1616,0.577649527806925,0.780702944768625,1548,0,0,1548,493,2041,216,24,"February 2025","February-2025-AE-by-provider-1zaQ6.xls",31
2025-02-01,"RDY","NHS England South West","Dorset Healthcare University NHS Foundation Trust",0,0,0,0,0,0,0,0,NA,NA,0,0,5,5,0,5,0,0,"February 2025","February-2025-AE-by-provider-1zaQ6.xls",31
2025-02-01,"RTQ","NHS England South West","Gloucestershire Health And Care NHS Foundation Trust",0,0,6854,6854,0,0,56,56,NA,0.991829588561424,0,0,0,0,20,20,0,0,"February 2025","February-2025-AE-by-provider-1zaQ6.xls",31
2025-02-01,"RTE","NHS England South West","Gloucestershire Hospitals NHS Foundation Trust",11727,0,0,11727,4621,0,0,4621,0.605952076404878,0.605952076404878,2435,0,0,2435,2179,4614,801,423,"February 2025","February-2025-AE-by-provider-1zaQ6.xls",31
2025-02-01,"RN3","NHS England South West","Great Western Hospitals NHS Foundation Trust",4962,0,4772,9734,2388,0,288,2676,0.518742442563482,0.72508732278611,2201,0,0,2201,1323,3524,781,378,"February 2025","February-2025-AE-by-provider-1zaQ6.xls",31
2025-02-01,"RVJ","NHS England South West","North Bristol NHS Trust",7941,0,0,7941,3225,0,0,3225,0.593879863996978,0.593879863996978,2563,0,0,2563,2324,4887,915,536,"February 2025","February-2025-AE-by-provider-1zaQ6.xls",31
2025-02-01,"L83087","NHS England South West","Okehampton Medical Centre",0,0,69,69,0,0,0,0,NA,1,0,0,0,0,0,0,0,0,"February 2025","February-2025-AE-by-provider-1zaQ6.xls",31
2025-02-01,"NQT5H","NHS England South West","Paulton Memorial Hospital",0,0,913,913,0,0,5,5,NA,0.994523548740416,0,0,0,0,0,0,0,0,"February 2025","February-2025-AE-by-provider-1zaQ6.xls",31
2025-02-01,"REF","NHS England South West","Royal Cornwall Hospitals NHS Trust",5765,0,10121,15886,3114,0,487,3601,0.459843885516045,0.773322422258592,2361,0,35,2396,1046,3442,919,253,"February 2025","February-2025-AE-by-provider-1zaQ6.xls",31
2025-02-01,"RH8","NHS England South West","Royal Devon University Healthcare NHS Foundation Trust",12019,0,3969,15988,5267,0,17,5284,0.561777186121974,0.669502126594946,3104,0,0,3104,1787,4891,1465,79,"February 2025","February-2025-AE-by-provider-1zaQ6.xls",31
2025-02-01,"RD1","NHS England South West","Royal United Hospitals Bath NHS Foundation Trust",7674,0,0,7674,3269,0,0,3269,0.574016158457128,0.574016158457128,2305,0,12,2317,1594,3911,968,205,"February 2025","February-2025-AE-by-provider-1zaQ6.xls",31
2025-02-01,"RNZ","NHS England South West","Salisbury NHS Foundation Trust",4263,276,1584,6123,2008,0,0,2008,0.528970208773164,0.672056181610322,1202,0,0,1202,907,2109,529,52,"February 2025","February-2025-AE-by-provider-1zaQ6.xls",31
2025-02-01,"NLX","NHS England South West","Sirona Care & Health",0,0,7829,7829,0,0,385,385,NA,0.950823860007664,0,0,0,0,0,0,0,0,"February 2025","February-2025-AE-by-provider-1zaQ6.xls",31
2025-02-01,"RH5","NHS England South West","Somerset NHS Foundation Trust",10816,0,8601,19417,5066,0,168,5234,0.531619822485207,0.730442395838698,2698,0,0,2698,1604,4302,846,271,"February 2025","February-2025-AE-by-provider-1zaQ6.xls",31
2025-02-01,"RYF","NHS England South West","South Western Ambulance Service NHS Foundation Trust",0,0,1648,1648,0,0,18,18,NA,0.989077669902912,0,0,0,0,0,0,0,0,"February 2025","February-2025-AE-by-provider-1zaQ6.xls",31
2025-02-01,"AAH","NHS England South West","Tetbury Hospital Trust Ltd",0,0,545,545,0,0,0,0,NA,1,0,0,0,0,0,0,0,0,"February 2025","February-2025-AE-by-provider-1zaQ6.xls",31
2025-02-01,"RA9","NHS England South West","Torbay And South Devon NHS Foundation Trust",5925,0,2819,8744,2701,0,22,2723,0.544135021097046,0.688586459286368,1931,0,0,1931,1093,3024,365,50,"February 2025","February-2025-AE-by-provider-1zaQ6.xls",31
2025-02-01,"RA7","NHS England South West","University Hospitals Bristol And Weston NHS Foundation Trust",13998,2114,0,16112,5660,175,0,5835,0.595656522360337,0.637847567030784,4689,11,0,4700,1483,6183,1782,664,"February 2025","February-2025-AE-by-provider-1zaQ6.xls",31
2025-02-01,"R0D","NHS England South West","University Hospitals Dorset NHS Foundation Trust",11840,0,4341,16181,4892,0,0,4892,0.586824324324324,0.697670106915518,3751,1,0,3752,2204,5956,1235,275,"February 2025","February-2025-AE-by-provider-1zaQ6.xls",31
2025-02-01,"RK9","NHS England South West","University Hospitals Plymouth NHS Trust",8072,131,4653,12856,4218,0,101,4319,0.477452923686819,0.664047915370255,2599,0,0,2599,1331,3930,1024,541,"February 2025","February-2025-AE-by-provider-1zaQ6.xls",31
2025-02-01,"AXG","NHS England South West","Wiltshire Health & Care",0,0,2090,2090,0,0,17,17,NA,0.991866028708134,0,0,0,0,0,0,0,0,"February 2025","February-2025-AE-by-provider-1zaQ6.xls",31
2025-01-01,"RC9","NHS England East Of England","Bedfordshire Hospitals NHS Foundation Trust",15468,0,9712,25180,7204,0,0,7204,0.534264287561417,0.713899920571882,4816,0,0,4816,2319,7135,105,22,"January 2025","January-2025-AE-by-provider-HyTsU (1).xls",0
2025-01-01,"RGT","NHS England East Of England","Cambridge University Hospitals NHS Foundation Trust",10098,0,5846,15944,4662,0,42,4704,0.538324420677362,0.704967385850477,2710,0,33,2743,525,3268,1166,646,"January 2025","January-2025-AE-by-provider-HyTsU (1).xls",0
2025-01-01,"RWH","NHS England East Of England","East And North Hertfordshire NHS Trust",8687,0,7191,15878,4818,0,28,4846,0.445378151260504,0.694797833480287,2953,0,2,2955,178,3133,615,340,"January 2025","January-2025-AE-by-provider-HyTsU (1).xls",0
2025-01-01,"RDE","NHS England East Of England","East Suffolk And North Essex NHS Foundation Trust",12889,0,14577,27466,6231,0,288,6519,0.516564512374893,0.762652006116653,6166,0,413,6579,1107,7686,1865,885,"January 2025","January-2025-AE-by-provider-HyTsU (1).xls",0
2025-01-01,"RY4","NHS England East Of England","Hertfordshire Community NHS Trust",0,0,1125,1125,0,0,37,37,NA,0.967111111111111,0,0,0,0,0,0,0,0,"January 2025","January-2025-AE-by-provider-HyTsU (1).xls",0
2025-01-01,"DT301","NHS England East Of England","Herts Urgent Care (Ascots Lane)",0,0,2063,2063,0,0,56,56,NA,0.972855065438682,0,0,0,0,0,0,0,0,"January 2025","January-2025-AE-by-provider-HyTsU (1).xls",0
2025-01-01,"RGP","NHS England East Of England","James Paget University Hospitals NHS Foundation Trust",6535,0,1515,8050,3057,0,0,3057,0.53221117061974,0.620248447204969,1611,0,0,1611,498,2109,1062,456,"January 2025","January-2025-AE-by-provider-HyTsU (1).xls",0
2025-01-01,"RAJ","NHS England East Of England","Mid And South Essex NHS Foundation Trust",28976,0,3905,32881,11070,0,247,11317,0.617959690778575,0.65581947021076,8794,0,198,8992,1398,10390,3698,451,"January 2025","January-2025-AE-by-provider-HyTsU (1).xls",0
2025-01-01,"RD8","NHS England East Of England","Milton Keynes University Hospital NHS Foundation Trust",8432,0,4961,13393,3460,0,236,3696,0.58965844402277,0.724034943627268,2167,0,0,2167,464,2631,1025,0,"January 2025","January-2025-AE-by-provider-HyTsU (1).xls",0
2025-01-01,"RM1","NHS England East Of England","Norfolk And Norwich University Hospitals NHS Foundation Trust",12018,0,8406,20424,4148,0,6,4154,0.654851056748211,0.796611829220525,2563,0,0,2563,1680,4243,1416,379,"January 2025","January-2025-AE-by-provider-HyTsU (1).xls",0
2025-01-01,"RGN","NHS England East Of England","North West Anglia NHS Foundation Trust",14552,0,4436,18988,6162,0,151,6313,0.576553051126993,0.667526859068886,3744,0,48,3792,1647,5439,1467,883,"January 2025","January-2025-AE-by-provider-HyTsU (1).xls",0
2025-01-01,"Y02428","NHS England East Of England","Putnoe Walk In Centre",0,0,3234,3234,0,0,0,0,NA,1,0,0,0,0,0,0,0,0,"January 2025","January-2025-AE-by-provider-HyTsU (1).xls",0
2025-01-01,"RQW","NHS England East Of England","The Princess Alexandra Hospital NHS Trust",7889,0,2534,10423,4506,0,0,4506,0.428824946127519,0.56768684639739,1692,0,0,1692,224,1916,743,190,"January 2025","January-2025-AE-by-provider-HyTsU (1).xls",0
2025-01-01,"RCX","NHS England East Of England","The Queen Elizabeth Hospital, King's Lynn, NHS Foundation Trust",6370,0,1131,7501,2953,0,0,2953,0.536420722135008,0.606319157445674,2035,0,0,2035,313,2348,387,122,"January 2025","January-2025-AE-by-provider-HyTsU (1).xls",0
2025-01-01,"RWG","NHS England East Of England","West Hertfordshire Teaching Hospitals NHS Trust",8229,0,7492,15721,3010,0,92,3102,0.634220439907644,0.802684307614019,4215,0,0,4215,601,4816,947,28,"January 2025","January-2025-AE-by-provider-HyTsU (1).xls",0
2025-01-01,"RGR","NHS England East Of England","West Suffolk NHS Foundation Trust",7481,0,669,8150,2959,0,0,2959,0.604464643764203,0.636932515337423,1829,0,0,1829,290,2119,1182,707,"January 2025","January-2025-AE-by-provider-HyTsU (1).xls",0
2025-01-01,"G0Q0L","NHS England London","Barking Hospital Utc",0,0,2777,2777,0,0,12,12,NA,0.995678790061217,0,0,0,0,0,0,0,0,"January 2025","January-2025-AE-by-provider-HyTsU (1).xls",0
2025-01-01,"RF4","NHS England London","Barking, Havering And Redbridge University Hospitals NHS Trust",13814,2497,14157,30468,6286,360,143,6789,0.544954394092949,0.777176053564395,8389,0,0,8389,426,8815,1762,1064,"January 2025","January-2025-AE-by-provider-HyTsU (1).xls",0
2025-01-01,"R1H","NHS England London","Barts Health NHS Trust",25012,944,17880,43836,11280,14,1536,12830,0.549016472093395,0.707318185965873,4419,2,32,4453,1236,5689,2344,1319,"January 2025","January-2025-AE-by-provider-HyTsU (1).xls",0
2025-01-01,"AD913","NHS England London","Beckenham Beacon Ucc",0,0,3803,3803,0,0,33,33,NA,0.991322640021036,0,0,0,0,0,0,0,0,"January 2025","January-2025-AE-by-provider-HyTsU (1).xls",0
2025-01-01,"RYX","NHS England London","Central London Community Healthcare NHS Trust",0,0,12482,12482,0,0,174,174,NA,0.986059926293863,0,0,0,0,0,0,0,0,"January 2025","January-2025-AE-by-provider-HyTsU (1).xls",0
2025-01-01,"RQM","NHS England London","Chelsea And Westminster Hospital NHS Foundation Trust",20200,0,6169,26369,6626,0,160,6786,0.671980198019802,0.742652356934279,2841,0,0,2841,433,3274,1510,56,"January 2025","January-2025-AE-by-provider-HyTsU (1).xls",0
2025-01-01,"RJ6","NHS England London","Croydon Health Services NHS Trust",12997,0,5212,18209,5139,0,0,5139,0.604601061783488,0.717776923499368,1209,0,0,1209,167,1376,730,441,"January 2025","January-2025-AE-by-provider-HyTsU (1).xls",0
2025-01-01,"RVR","NHS England London","Epsom And St Helier University Hospitals NHS Trust",10999,351,1489,12839,3192,0,51,3243,0.709791799254478,0.747410234441935,1916,5,0,1921,167,2088,990,739,"January 2025","January-2025-AE-by-provider-HyTsU (1).xls",0
2025-01-01,"RJ1","NHS England London","Guy's And St Thomas' NHS Foundation Trust",9690,724,6461,16875,3843,20,141,4004,0.603405572755418,0.762725925925926,2114,0,0,2114,358,2472,245,71,"January 2025","January-2025-AE-by-provider-HyTsU (1).xls",0
2025-01-01,"K6K0R","NHS England London","Harold Wood Polyclinic Utc",0,0,2825,2825,0,0,4,4,NA,0.99858407079646,0,0,0,0,0,0,0,0,"January 2025","January-2025-AE-by-provider-HyTsU (1).xls",0
2025-01-01,"RQX","NHS England London","Homerton Healthcare NHS Foundation Trust",10961,0,0,10961,2378,0,0,2378,0.783048991880303,0.783048991880303,1836,0,0,1836,380,2216,375,24,"January 2025","January-2025-AE-by-provider-HyTsU (1).xls",0
2025-01-01,"RYJ","NHS England London","Imperial College Healthcare NHS Trust",12227,3650,7672,23549,5362,21,417,5800,0.561462337449906,0.753705040553739,3722,1,0,3723,1219,4942,1207,551,"January 2025","January-2025-AE-by-provider-HyTsU (1).xls",0
2025-01-01,"RJZ","NHS England London","King's College Hospital NHS Foundation Trust",15149,0,10034,25183,7186,0,387,7573,0.525645257112681,0.699281261168248,3632,0,0,3632,366,3998,2698,1279,"January 2025","January-2025-AE-by-provider-HyTsU (1).xls",0
2025-01-01,"RAX","NHS England London","Kingston And Richmond NHS Foundation Trust",7258,0,7797,15055,3722,0,262,3984,0.487186552769358,0.735370308867486,2449,0,177,2626,340,2966,780,439,"January 2025","January-2025-AE-by-provider-HyTsU (1).xls",0
2025-01-01,"RJ2","NHS England London","Lewisham And Greenwich NHS Trust",14126,0,10954,25080,7503,0,1298,8801,0.468851762707065,0.64908293460925,5055,0,0,5055,1338,6393,1986,834,"January 2025","January-2025-AE-by-provider-HyTsU (1).xls",0
2025-01-01,"R1K","NHS England London","London North West University Healthcare NHS Trust",13728,0,14754,28482,7460,0,162,7622,0.456585081585082,0.732392388174988,6525,0,0,6525,347,6872,1507,738,"January 2025","January-2025-AE-by-provider-HyTsU (1).xls",0
2025-01-01,"RP6","NHS England London","Moorfields Eye Hospital NHS Foundation Trust",0,5778,0,5778,0,117,0,117,NA,0.979750778816199,0,1,0,1,220,221,0,0,"January 2025","January-2025-AE-by-provider-HyTsU (1).xls",0
2025-01-01,"RAT","NHS England London","North East London NHS Foundation Trust",0,0,1674,1674,0,0,46,46,NA,0.972520908004779,0,0,0,0,0,0,0,0,"January 2025","January-2025-AE-by-provider-HyTsU (1).xls",0
2025-01-01,"RAL","NHS England London","Royal Free London NHS Foundation Trust",25100,472,15445,41017,9985,5,944,10934,0.602191235059761,0.733427603188922,4965,0,55,5020,750,5770,3157,1939,"January 2025","January-2025-AE-by-provider-HyTsU (1).xls",0
2025-01-01,"RAN","NHS England London","Royal National Orthopaedic Hospital NHS Trust",0,0,0,0,0,0,0,0,NA,NA,0,0,0,0,45,45,0,0,"January 2025","January-2025-AE-by-provider-HyTsU (1).xls",0
2025-01-01,"RJ7","NHS England London","St George's University Hospitals NHS Foundation Trust",9333,0,3322,12655,2745,0,0,2745,0.705882352941177,0.783089687870407,2575,0,0,2575,806,3381,1412,838,"January 2025","January-2025-AE-by-provider-HyTsU (1).xls",0
2025-01-01,"RAS","NHS England London","The Hillingdon Hospitals NHS Foundation Trust",5973,0,6578,12551,3503,0,186,3689,0.413527540599364,0.706079196876743,1815,0,0,1815,74,1889,810,79,"January 2025","January-2025-AE-by-provider-HyTsU (1).xls",0
2025-01-01,"Y03218","NHS England London","The Pinn Unregistered Wic",0,0,897,897,0,0,0,0,NA,1,0,0,0,0,0,0,0,0,"January 2025","January-2025-AE-by-provider-HyTsU (1).xls",0
2025-01-01,"RRV","NHS England London","University College London Hospitals NHS Foundation Trust",13061,0,0,13061,3457,0,0,3457,0.735318888293392,0.735318888293392,1343,0,0,1343,251,1594,638,244,"January 2025","January-2025-AE-by-provider-HyTsU (1).xls",0
2025-01-01,"Y02147","NHS England London","Urgent Care Centre (Qms)",0,0,8228,8228,0,0,179,179,NA,0.978245017015071,0,0,0,0,0,0,0,0,"January 2025","January-2025-AE-by-provider-HyTsU (1).xls",0
2025-01-01,"RKE","NHS England London","Whittington Health NHS Trust",9061,0,0,9061,2865,0,0,2865,0.683809734024942,0.683809734024942,1137,0,0,1137,48,1185,597,466,"January 2025","January-2025-AE-by-provider-HyTsU (1).xls",0
2025-01-01,"NL7","NHS England Midlands","Assura Vertis Urgent Care Centres (Birmingham)",0,0,4432,4432,0,0,0,0,NA,1,0,0,0,0,0,0,0,0,"January 2025","January-2025-AE-by-provider-HyTsU (1).xls",0
2025-01-01,"8J094","NHS England Midlands","Badger Ltd",0,0,1429,1429,0,0,0,0,NA,1,0,0,0,0,0,0,0,0,"January 2025","January-2025-AE-by-provider-HyTsU (1).xls",0
2025-01-01,"RQ3","NHS England Midlands","Birmingham Women's And Children's NHS Foundation Trust",4731,0,0,4731,744,0,0,744,0.842739378566899,0.842739378566899,967,0,0,967,161,1128,11,11,"January 2025","January-2025-AE-by-provider-HyTsU (1).xls",0
2025-01-01,"RFS","NHS England Midlands","Chesterfield Royal Hospital NHS Foundation Trust",6756,0,5745,12501,3541,0,316,3857,0.475873297809355,0.691464682825374,2712,0,312,3024,694,3718,1616,392,"January 2025","January-2025-AE-by-provider-HyTsU (1).xls",0
2025-01-01,"RYG","NHS England Midlands","Coventry And Warwickshire Partnership NHS Trust",0,0,0,0,0,0,0,0,NA,NA,0,0,4,4,81,85,0,0,"January 2025","January-2025-AE-by-provider-HyTsU (1).xls",0
2025-01-01,"RY8","NHS England Midlands","Derbyshire Community Health Services NHS Foundation Trust",0,0,8066,8066,0,0,94,94,NA,0.988346144309447,0,0,0,0,0,0,0,0,"January 2025","January-2025-AE-by-provider-HyTsU (1).xls",0
2025-01-01,"NNJ","NHS England Midlands","Dhu Health Care C.I.C",0,0,1813,1813,0,0,0,0,NA,1,0,0,0,0,0,0,0,0,"January 2025","January-2025-AE-by-provider-HyTsU (1).xls",0
2025-01-01,"Y03007","NHS England Midlands","Erdington GP Health & Wellbeing Wic",0,0,2337,2337,0,0,0,0,NA,1,0,0,0,0,0,0,0,0,"January 2025","January-2025-AE-by-provider-HyTsU (1).xls",0
2025-01-01,"RLT","NHS England Midlands","George Eliot Hospital NHS Trust",6748,0,1527,8275,2378,0,19,2397,0.647599288678127,0.710332326283988,1130,0,0,1130,0,1130,790,224,"January 2025","January-2025-AE-by-provider-HyTsU (1).xls",0
2025-01-01,"RNQ","NHS England Midlands","Kettering General Hospital NHS Foundation Trust",10159,0,8542,18701,3720,0,155,3875,0.633822226597106,0.79279182931394,1899,0,0,1899,327,2226,1388,0,"January 2025","January-2025-AE-by-provider-HyTsU (1).xls",0
2025-01-01,"C82038","NHS England Midlands","Latham House Medical Practice",0,0,305,305,0,0,0,0,NA,1,0,0,0,0,0,0,0,0,"January 2025","January-2025-AE-by-provider-HyTsU (1).xls",0
2025-01-01,"RY5","NHS England Midlands","Lincolnshire Community Health Services NHS Trust",0,0,7706,7706,0,0,273,273,NA,0.964573059953283,0,0,0,0,0,0,0,0,"January 2025","January-2025-AE-by-provider-HyTsU (1).xls",0
2025-01-01,"NNJ0H","NHS England Midlands","Llr Ea - The Merlyn Vaz Health & Social Care Centre",0,0,2411,2411,0,0,0,0,NA,1,0,0,0,0,0,0,0,0,"January 2025","January-2025-AE-by-provider-HyTsU (1).xls",0
2025-01-01,"NNJ07","NHS England Midlands","Loughborough Urgent Care Centre",0,0,7843,7843,0,0,46,46,NA,0.994134897360704,0,0,0,0,0,0,0,0,"January 2025","January-2025-AE-by-provider-HyTsU (1).xls",0
2025-01-01,"NNJ12","NHS England Midlands","Market Harborough",0,0,677,677,0,0,0,0,NA,1,0,0,0,0,0,0,0,0,"January 2025","January-2025-AE-by-provider-HyTsU (1).xls",0
2025-01-01,"C82009","NHS England Midlands","Market Harborough Med.Ctr",0,0,247,247,0,0,0,0,NA,1,0,0,0,0,0,0,0,0,"January 2025","January-2025-AE-by-provider-HyTsU (1).xls",0
2025-01-01,"NNJ13","NHS England Midlands","Melton Mowbray",0,0,562,562,0,0,0,0,NA,1,0,0,0,0,0,0,0,0,"January 2025","January-2025-AE-by-provider-HyTsU (1).xls",0
2025-01-01,"RNS","NHS England Midlands","Northampton General Hospital NHS Trust",9841,576,2363,12780,3966,14,138,4118,0.596992175591911,0.677777777777778,2282,0,0,2282,906,3188,1394,938,"January 2025","January-2025-AE-by-provider-HyTsU (1).xls",0
2025-01-01,"NR3","NHS England Midlands","Nottingham Citycare Partnership",0,0,5409,5409,0,0,604,604,NA,0.888334257718617,0,0,0,0,0,0,0,0,"January 2025","January-2025-AE-by-provider-HyTsU (1).xls",0
2025-01-01,"RX1","NHS England Midlands","Nottingham University Hospitals NHS Trust",15464,1684,296,17444,7941,70,7,8018,0.48648473874806,0.540357716120156,4567,0,0,4567,4489,9056,1416,779,"January 2025","January-2025-AE-by-provider-HyTsU (1).xls",0
2025-01-01,"NNJ14","NHS England Midlands","Oadby",0,0,3890,3890,0,0,0,0,NA,1,0,0,0,0,0,0,0,0,"January 2025","January-2025-AE-by-provider-HyTsU (1).xls",0
2025-01-01,"NNJ15","NHS England Midlands","Oakham",0,0,430,430,0,0,0,0,NA,1,0,0,0,0,0,0,0,0,"January 2025","January-2025-AE-by-provider-HyTsU (1).xls",0
2025-01-01,"RXK","NHS England Midlands","Sandwell And West Birmingham Hospitals NHS Trust",11281,1103,8325,20709,4832,183,294,5309,0.571669178264338,0.743638031773625,2578,0,0,2578,507,3085,1000,196,"January 2025","January-2025-AE-by-provider-HyTsU (1).xls",0
2025-01-01,"RK5","NHS England Midlands","Sherwood Forest Hospitals NHS Foundation Trust",10447,0,5515,15962,5047,0,488,5535,0.516894802335599,0.65323894248841,3786,0,0,3786,256,4042,1087,189,"January 2025","January-2025-AE-by-provider-HyTsU (1).xls",0
2025-01-01,"R1D","NHS England Midlands","Shropshire Community Health NHS Trust",0,0,2889,2889,0,0,3,3,NA,0.998961578400831,0,0,0,0,0,0,0,0,"January 2025","January-2025-AE-by-provider-HyTsU (1).xls",0
2025-01-01,"C83023","NHS England Midlands","Sleaford Medical Group",0,0,495,495,0,0,0,0,NA,1,0,0,0,0,0,0,0,0,"January 2025","January-2025-AE-by-provider-HyTsU (1).xls",0
2025-01-01,"Y02615","NHS England Midlands","South Birmingham GP Walk In Centre",0,0,7079,7079,0,0,0,0,NA,1,0,0,0,0,0,0,0,0,"January 2025","January-2025-AE-by-provider-HyTsU (1).xls",0
2025-01-01,"RJC","NHS England Midlands","South Warwickshire University NHS Foundation Trust",7499,0,330,7829,2820,0,0,2820,0.623949859981331,0.639800740835356,2241,0,0,2241,914,3155,602,122,"January 2025","January-2025-AE-by-provider-HyTsU (1).xls",0
2025-01-01,"NQTE4","NHS England Midlands","Summerfield Urgent Care Centre",0,0,3194,3194,0,0,0,0,NA,1,0,0,0,0,0,0,0,0,"January 2025","January-2025-AE-by-provider-HyTsU (1).xls",0
2025-01-01,"RNA","NHS England Midlands","The Dudley Group NHS Foundation Trust",8787,0,4911,13698,2924,0,120,3044,0.66723568908615,0.777777777777778,3650,0,0,3650,2582,6232,2016,95,"January 2025","January-2025-AE-by-provider-HyTsU (1).xls",0
2025-01-01,"RL1","NHS England Midlands","The Robert Jones And Agnes Hunt Orthopaedic Hospital NHS Foundation Trust",0,0,0,0,0,0,0,0,NA,NA,0,0,0,0,27,27,0,0,"January 2025","January-2025-AE-by-provider-HyTsU (1).xls",0
2025-01-01,"RL4","NHS England Midlands","The Royal Wolverhampton NHS Trust",12070,0,8801,20871,3683,0,138,3821,0.694863297431649,0.816923003210196,5690,0,0,5690,940,6630,1438,847,"January 2025","January-2025-AE-by-provider-HyTsU (1).xls",0
2025-01-01,"RXW","NHS England Midlands","The Shrewsbury And Telford Hospital NHS Trust",9443,0,2370,11813,5433,0,202,5635,0.424653182251403,0.522983154152205,3068,0,178,3246,2217,5463,1665,1316,"January 2025","January-2025-AE-by-provider-HyTsU (1).xls",0
2025-01-01,"RWD","NHS England Midlands","United Lincolnshire Teaching Hospitals NHS Trust",15569,0,3568,19137,6284,0,714,6998,0.596377416661314,0.634320948947066,4703,0,0,4703,1153,5856,2194,1317,"January 2025","January-2025-AE-by-provider-HyTsU (1).xls",0
2025-01-01,"RRK","NHS England Midlands","University Hospitals Birmingham NHS Foundation Trust",33067,325,1986,35378,13753,0,41,13794,0.584086853963166,0.610096670247046,10511,0,0,10511,6876,17387,4518,1847,"January 2025","January-2025-AE-by-provider-HyTsU (1).xls",0
2025-01-01,"RKB","NHS England Midlands","University Hospitals Coventry And Warwickshire NHS Trust",11610,1525,6128,19263,5201,151,184,5536,0.552024117140396,0.71260966619945,1779,40,71,1890,661,2551,126,30,"January 2025","January-2025-AE-by-provider-HyTsU (1).xls",0
2025-01-01,"RTG","NHS England Midlands","University Hospitals Of Derby And Burton NHS Foundation Trust",19513,0,9252,28765,9167,0,6,9173,0.530210628811562,0.681105510168608,3962,0,2,3964,1957,5921,1972,1028,"January 2025","January-2025-AE-by-provider-HyTsU (1).xls",0
2025-01-01,"RWE","NHS England Midlands","University Hospitals Of Leicester NHS Trust",21070,1977,0,23047,9121,102,0,9223,0.567109634551495,0.599817763700265,6395,5,0,6400,3749,10149,2691,1178,"January 2025","January-2025-AE-by-provider-HyTsU (1).xls",0
2025-01-01,"RJE","NHS England Midlands","University Hospitals Of North Midlands NHS Trust",14091,490,8517,23098,7510,0,256,7766,0.467035696543893,0.663780413888648,5493,0,0,5493,3127,8620,2233,1318,"January 2025","January-2025-AE-by-provider-HyTsU (1).xls",0
2025-01-01,"RBK","NHS England Midlands","Walsall Healthcare NHS Trust",9072,0,4055,13127,3517,0,62,3579,0.612323633156966,0.727355831492344,3896,0,0,3896,807,4703,1661,324,"January 2025","January-2025-AE-by-provider-HyTsU (1).xls",0
2025-01-01,"RWP","NHS England Midlands","Worcestershire Acute Hospitals NHS Trust",12351,0,5089,17440,7172,0,37,7209,0.419318273823982,0.586639908256881,2758,0,0,2758,858,3616,1682,713,"January 2025","January-2025-AE-by-provider-HyTsU (1).xls",0
2025-01-01,"RLQ","NHS England Midlands","Wye Valley NHS Trust",5660,1141,123,6924,2488,0,0,2488,0.560424028268551,0.640670132871173,1416,0,0,1416,135,1551,762,323,"January 2025","January-2025-AE-by-provider-HyTsU (1).xls",0
2025-01-01,"RCF","NHS England North East And Yorkshire","Airedale NHS Foundation Trust",5917,250,0,6167,2341,0,0,2341,0.604360317728579,0.6203988973569,1554,0,0,1554,562,2116,717,237,"January 2025","January-2025-AE-by-provider-HyTsU (1).xls",0
2025-01-01,"RFF","NHS England North East And Yorkshire","Barnsley Hospital NHS Foundation Trust",8683,0,0,8683,3459,0,0,3459,0.601635379477139,0.601635379477139,2894,0,0,2894,516,3410,795,0,"January 2025","January-2025-AE-by-provider-HyTsU (1).xls",0
2025-01-01,"RAE","NHS England North East And Yorkshire","Bradford Teaching Hospitals NHS Foundation Trust",8851,961,2947,12759,2289,0,0,2289,0.741385154219862,0.820597225487891,2521,0,33,2554,1486,4040,832,122,"January 2025","January-2025-AE-by-provider-HyTsU (1).xls",0
2025-01-01,"NNF09","NHS England North East And Yorkshire","Bransholme Health Centre",0,0,3572,3572,0,0,339,339,NA,0.905095184770437,0,0,0,0,0,0,0,0,"January 2025","January-2025-AE-by-provider-HyTsU (1).xls",0
2025-01-01,"NNF16","NHS England North East And Yorkshire","Bridlington Hospital",0,0,1306,1306,0,0,26,26,NA,0.980091883614089,0,0,0,0,0,0,0,0,"January 2025","January-2025-AE-by-provider-HyTsU (1).xls",0
2025-01-01,"RWY","NHS England North East And Yorkshire","Calderdale And Huddersfield NHS Foundation Trust",14485,0,0,14485,4954,0,0,4954,0.657991025198481,0.657991025198481,2970,0,0,2970,219,3189,1460,33,"January 2025","January-2025-AE-by-provider-HyTsU (1).xls",0
2025-01-01,"RXP","NHS England North East And Yorkshire","County Durham And Darlington NHS Foundation Trust",12293,0,11048,23341,5250,0,0,5250,0.57292768242089,0.775073904288591,4334,0,0,4334,810,5144,2450,23,"January 2025","January-2025-AE-by-provider-HyTsU (1).xls",0
2025-01-01,"RP5","NHS England North East And Yorkshire","Doncaster And Bassetlaw Teaching Hospitals NHS Foundation Trust",13236,0,3840,17076,5143,0,5,5148,0.611438501057721,0.69852424455376,4208,0,355,4563,1068,5631,1403,255,"January 2025","January-2025-AE-by-provider-HyTsU (1).xls",0
2025-01-01,"NNF94","NHS England North East And Yorkshire","East Riding Community Hospital",0,0,2563,2563,0,0,128,128,NA,0.950058525165821,0,0,0,0,0,0,0,0,"January 2025","January-2025-AE-by-provider-HyTsU (1).xls",0
2025-01-01,"RR7","NHS England North East And Yorkshire","Gateshead Health NHS Foundation Trust",5892,0,3131,9023,2561,0,37,2598,0.565342837746096,0.7120691565998,1654,0,0,1654,57,1711,1033,0,"January 2025","January-2025-AE-by-provider-HyTsU (1).xls",0
2025-01-01,"NNFA7","NHS England North East And Yorkshire","Goole & District Hospital",0,0,1387,1387,0,0,6,6,NA,0.995674116798846,0,0,0,0,0,0,0,0,"January 2025","January-2025-AE-by-provider-HyTsU (1).xls",0
2025-01-01,"RCD","NHS England North East And Yorkshire","Harrogate And District NHS Foundation Trust",5100,0,878,5978,1628,0,0,1628,0.68078431372549,0.727668116426899,1173,0,0,1173,289,1462,550,90,"January 2025","January-2025-AE-by-provider-HyTsU (1).xls",0
2025-01-01,"RWA","NHS England North East And Yorkshire","Hull University Teaching Hospitals NHS Trust",8707,0,4795,13502,5136,0,441,5577,0.41012978063627,0.586950081469412,3502,0,0,3502,2373,5875,1690,614,"January 2025","January-2025-AE-by-provider-HyTsU (1).xls",0
2025-01-01,"RV9","NHS England North East And Yorkshire","Humber Teaching NHS Foundation Trust",0,0,1003,1003,0,0,6,6,NA,0.994017946161516,0,0,0,0,0,0,0,0,"January 2025","January-2025-AE-by-provider-HyTsU (1).xls",0
2025-01-01,"RR8","NHS England North East And Yorkshire","Leeds Teaching Hospitals NHS Trust",16926,684,11250,28860,7399,0,98,7497,0.562861869313482,0.74022869022869,3763,0,0,3763,1332,5095,2316,679,"January 2025","January-2025-AE-by-provider-HyTsU (1).xls",0
2025-01-01,"ARN03","NHS England North East And Yorkshire","Local Care Direct",0,0,2291,2291,0,0,9,9,NA,0.996071584460934,0,0,0,0,0,0,0,0,"January 2025","January-2025-AE-by-provider-HyTsU (1).xls",0
2025-01-01,"RXF","NHS England North East And Yorkshire","Mid Yorkshire Teaching NHS Trust",15560,181,5334,21075,6334,0,266,6600,0.59293059125964,0.686832740213523,3382,0,150,3532,827,4359,3628,1191,"January 2025","January-2025-AE-by-provider-HyTsU (1).xls",0
2025-01-01,"RNN","NHS England North East And Yorkshire","North Cumbria Integrated Care NHS Foundation Trust",8459,0,1668,10127,4133,0,33,4166,0.511407967844899,0.588624469240644,2420,0,0,2420,851,3271,1427,657,"January 2025","January-2025-AE-by-provider-HyTsU (1).xls",0
2025-01-01,"RVW","NHS England North East And Yorkshire","North Tees And Hartlepool NHS Foundation Trust",4804,0,10523,15327,2841,0,22,2863,0.408617818484596,0.813205454426828,1690,0,509,2199,2439,4638,361,49,"January 2025","January-2025-AE-by-provider-HyTsU (1).xls",0
2025-01-01,"RJL","NHS England North East And Yorkshire","Northern Lincolnshire And Goole NHS Foundation Trust",8659,0,7065,15724,4696,0,54,4750,0.457674096315972,0.697914016789621,5519,0,0,5519,452,5971,1562,1018,"January 2025","January-2025-AE-by-provider-HyTsU (1).xls",0
2025-01-01,"RTF","NHS England North East And Yorkshire","Northumbria Healthcare NHS Foundation Trust",9372,0,10992,20364,2780,0,3,2783,0.703371745625267,0.86333726183461,3876,0,49,3925,395,4320,113,7,"January 2025","January-2025-AE-by-provider-HyTsU (1).xls",0
2025-01-01,"RCU","NHS England North East And Yorkshire","Sheffield Children's NHS Foundation Trust",4309,0,456,4765,287,0,0,287,0.933395219308424,0.939769150052466,1017,0,0,1017,72,1089,10,0,"January 2025","January-2025-AE-by-provider-HyTsU (1).xls",0
2025-01-01,"RHQ","NHS England North East And Yorkshire","Sheffield Teaching Hospitals NHS Foundation Trust",9234,1183,8071,18488,5233,0,314,5547,0.43329001516136,0.69996754651666,3721,0,0,3721,3082,6803,1556,22,"January 2025","January-2025-AE-by-provider-HyTsU (1).xls",0
2025-01-01,"RTR","NHS England North East And Yorkshire","South Tees Hospitals NHS Foundation Trust",7207,0,9734,16941,4011,0,377,4388,0.443457749410296,0.740983413021663,2662,0,108,2770,2405,5175,615,94,"January 2025","January-2025-AE-by-provider-HyTsU (1).xls",0
2025-01-01,"R0B","NHS England North East And Yorkshire","South Tyneside And Sunderland NHS Foundation Trust",11559,1172,6682,19413,6589,33,270,6892,0.42996799031058,0.644980167928708,4624,15,0,4639,1150,5789,1279,55,"January 2025","January-2025-AE-by-provider-HyTsU (1).xls",0
2025-01-01,"RXG","NHS England North East And Yorkshire","South West Yorkshire Partnership NHS Foundation Trust",0,0,0,0,0,0,0,0,NA,NA,0,0,0,0,104,104,0,0,"January 2025","January-2025-AE-by-provider-HyTsU (1).xls",0
2025-01-01,"RTD","NHS England North East And Yorkshire","The Newcastle Upon Tyne Hospitals NHS Foundation Trust",11656,1642,5840,19138,4559,150,1,4710,0.608870967741935,0.753892778764761,3591,24,0,3615,2909,6524,790,41,"January 2025","January-2025-AE-by-provider-HyTsU (1).xls",0
2025-01-01,"RFR","NHS England North East And Yorkshire","The Rotherham NHS Foundation Trust",8708,0,0,8708,3595,0,0,3595,0.587161231051906,0.587161231051906,1987,0,0,1987,249,2236,1056,109,"January 2025","January-2025-AE-by-provider-HyTsU (1).xls",0
2025-01-01,"AJN","NHS England North East And Yorkshire","Workington Health Limited",0,0,313,313,0,0,0,0,NA,1,0,0,0,0,0,0,0,0,"January 2025","January-2025-AE-by-provider-HyTsU (1).xls",0
2025-01-01,"RCB","NHS England North East And Yorkshire","York And Scarborough Teaching Hospitals NHS Foundation Trust",10119,388,5567,16074,5742,0,192,5934,0.432552623777053,0.630832400149309,4477,0,0,4477,1723,6200,1782,949,"January 2025","January-2025-AE-by-provider-HyTsU (1).xls",0
2025-01-01,"RBS","NHS England North West","Alder Hey Children's NHS Foundation Trust",5771,0,0,5771,1222,0,0,1222,0.788251602841795,0.788251602841795,860,0,0,860,316,1176,1,0,"January 2025","January-2025-AE-by-provider-HyTsU (1).xls",0
2025-01-01,"RXL","NHS England North West","Blackpool Teaching Hospitals NHS Foundation Trust",8599,0,10178,18777,4140,0,52,4192,0.51854866844982,0.776748149331629,2749,0,0,2749,1601,4350,1184,774,"January 2025","January-2025-AE-by-provider-HyTsU (1).xls",0
2025-01-01,"RMC","NHS England North West","Bolton NHS Foundation Trust",7890,0,3669,11559,3774,0,160,3934,0.521673003802281,0.659659140064019,2424,0,128,2552,1029,3581,1039,504,"January 2025","January-2025-AE-by-provider-HyTsU (1).xls",0
2025-01-01,"RY2","NHS England North West","Bridgewater Community Healthcare NHS Foundation Trust",0,0,3098,3098,0,0,41,41,NA,0.986765655261459,0,0,0,0,0,0,0,0,"January 2025","January-2025-AE-by-provider-HyTsU (1).xls",0
2025-01-01,"RJR","NHS England North West","Countess Of Chester Hospital NHS Foundation Trust",4792,0,2147,6939,2606,0,220,2826,0.456176961602671,0.592736705577173,1678,0,0,1678,1366,3044,943,717,"January 2025","January-2025-AE-by-provider-HyTsU (1).xls",0
2025-01-01,"RJN","NHS England North West","East Cheshire NHS Trust",4089,0,59,4148,2049,0,0,2049,0.498899486426999,0.50602700096432,784,0,0,784,208,992,605,451,"January 2025","January-2025-AE-by-provider-HyTsU (1).xls",0
2025-01-01,"RXR","NHS England North West","East Lancashire Hospitals NHS Trust",12294,0,9797,22091,4986,0,834,5820,0.594436310395315,0.736544294056403,3983,0,93,4076,1692,5768,1664,1310,"January 2025","January-2025-AE-by-provider-HyTsU (1).xls",0
2025-01-01,"RXN","NHS England North West","Lancashire Teaching Hospitals NHS Foundation Trust",11693,0,3479,15172,4685,0,88,4773,0.599332934234157,0.685407329290799,2938,0,101,3039,1443,4482,1489,511,"January 2025","January-2025-AE-by-provider-HyTsU (1).xls",0
2025-01-01,"RBQ","NHS England North West","Liverpool Heart And Chest Hospital NHS Foundation Trust",0,0,0,0,0,0,0,0,NA,NA,0,0,0,0,187,187,0,0,"January 2025","January-2025-AE-by-provider-HyTsU (1).xls",0
2025-01-01,"REM","NHS England North West","Liverpool University Hospitals NHS Foundation Trust",14723,1684,7490,23897,6717,24,122,6863,0.543775045846634,0.712809139222497,4597,0,0,4597,2238,6835,3151,1117,"January 2025","January-2025-AE-by-provider-HyTsU (1).xls",0
2025-01-01,"REP","NHS England North West","Liverpool Women's NHS Foundation Trust",0,1611,0,1611,0,155,0,155,NA,0.903786468032278,0,89,0,89,17,106,0,0,"January 2025","January-2025-AE-by-provider-HyTsU (1).xls",0
2025-01-01,"R0A","NHS England North West","Manchester University NHS Foundation Trust",27746,3459,11876,43081,13209,147,741,14097,0.523931377495855,0.672779183398714,5458,121,139,5718,444,6162,5205,749,"January 2025","January-2025-AE-by-provider-HyTsU (1).xls",0
2025-01-01,"RBN","NHS England North West","Mersey And West Lancashire Teaching Hospitals NHS Trust",16603,0,6642,23245,6210,0,53,6263,0.625971210022285,0.730565713056571,7454,0,0,7454,762,8216,934,482,"January 2025","January-2025-AE-by-provider-HyTsU (1).xls",0
2025-01-01,"RW4","NHS England North West","Mersey Care NHS Foundation Trust",0,0,12806,12806,0,0,162,162,NA,0.987349679837576,0,0,0,0,55,55,0,0,"January 2025","January-2025-AE-by-provider-HyTsU (1).xls",0
2025-01-01,"RBT","NHS England North West","Mid Cheshire Hospitals NHS Foundation Trust",6632,0,2762,9394,4017,0,53,4070,0.394300361881785,0.566744730679157,2149,0,0,2149,1294,3443,1269,724,"January 2025","January-2025-AE-by-provider-HyTsU (1).xls",0
2025-01-01,"Y02532","NHS England North West","Miriam Minor Emergency",0,0,1666,1666,0,0,8,8,NA,0.995198079231693,0,0,0,0,0,0,0,0,"January 2025","January-2025-AE-by-provider-HyTsU (1).xls",0
2025-01-01,"RM3","NHS England North West","Northern Care Alliance NHS Foundation Trust",24521,0,9020,33541,10941,0,424,11365,0.553811019126463,0.661160967174503,7213,0,314,7527,2240,9767,2652,1488,"January 2025","January-2025-AE-by-provider-HyTsU (1).xls",0
2025-01-01,"NV693","NHS England North West","Rossendale Miu & Ooh",0,0,920,920,0,0,1,1,NA,0.998913043478261,0,0,0,0,0,0,0,0,"January 2025","January-2025-AE-by-provider-HyTsU (1).xls",0
2025-01-01,"NQT5F","NHS England North West","Skelmersdale Walk In Centre",0,0,1730,1730,0,0,6,6,NA,0.996531791907514,0,0,0,0,0,0,0,0,"January 2025","January-2025-AE-by-provider-HyTsU (1).xls",0
2025-01-01,"RWJ","NHS England North West","Stockport NHS Foundation Trust",8161,0,1054,9215,3577,0,57,3634,0.561695870604093,0.605642973412914,2744,0,81,2825,901,3726,1289,500,"January 2025","January-2025-AE-by-provider-HyTsU (1).xls",0
2025-01-01,"RMP","NHS England North West","Tameside And Glossop Integrated Care NHS Foundation Trust",8822,0,3247,12069,4007,0,6,4013,0.545794604398096,0.667495235727898,1685,0,0,1685,285,1970,1029,798,"January 2025","January-2025-AE-by-provider-HyTsU (1).xls",0
2025-01-01,"RBV","NHS England North West","The Christie NHS Foundation Trust",0,0,0,0,0,0,0,0,NA,NA,0,0,0,0,778,778,0,0,"January 2025","January-2025-AE-by-provider-HyTsU (1).xls",0
2025-01-01,"RET","NHS England North West","The Walton Centre NHS Foundation Trust",0,0,0,0,0,0,0,0,NA,NA,0,0,0,0,173,173,0,0,"January 2025","January-2025-AE-by-provider-HyTsU (1).xls",0
2025-01-01,"RTX","NHS England North West","University Hospitals Of Morecambe Bay NHS Foundation Trust",8766,0,3656,12422,3278,0,93,3371,0.626055213324207,0.728626630172275,3200,0,30,3230,982,4212,1226,560,"January 2025","January-2025-AE-by-provider-HyTsU (1).xls",0
2025-01-01,"RWW","NHS England North West","Warrington And Halton Teaching Hospitals NHS Foundation Trust",6810,0,2751,9561,3604,0,21,3625,0.470778267254038,0.620855559041941,1716,0,0,1716,135,1851,1666,1131,"January 2025","January-2025-AE-by-provider-HyTsU (1).xls",0
2025-01-01,"RY7","NHS England North West","Wirral Community Health And Care NHS Foundation Trust",0,0,4232,4232,0,0,265,265,NA,0.937381852551985,0,0,0,0,0,0,0,0,"January 2025","January-2025-AE-by-provider-HyTsU (1).xls",0
2025-01-01,"RBL","NHS England North West","Wirral University Teaching Hospital NHS Foundation Trust",7439,0,2955,10394,3996,0,67,4063,0.462831025675494,0.609101404656533,2069,0,0,2069,1704,3773,1369,976,"January 2025","January-2025-AE-by-provider-HyTsU (1).xls",0
2025-01-01,"RRF","NHS England North West","Wrightington, Wigan And Leigh NHS Foundation Trust",7069,0,4671,11740,3999,0,70,4069,0.434290564436271,0.653407155025554,2013,0,0,2013,833,2846,1732,569,"January 2025","January-2025-AE-by-provider-HyTsU (1).xls",0
2025-01-01,"RTK","NHS England South East","Ashford And St Peter's Hospitals NHS Foundation Trust",10059,0,0,10059,3370,0,0,3370,0.664976637836763,0.664976637836763,2810,0,0,2810,725,3535,962,521,"January 2025","January-2025-AE-by-provider-HyTsU (1).xls",0
2025-01-01,"NTV0B","NHS England South East","Ashford Walk-In-Centre",0,0,2292,2292,0,0,91,91,NA,0.960296684118674,0,0,0,0,0,0,0,0,"January 2025","January-2025-AE-by-provider-HyTsU (1).xls",0
2025-01-01,"RWX","NHS England South East","Berkshire Healthcare NHS Foundation Trust",0,0,1264,1264,0,0,16,16,NA,0.987341772151899,0,0,39,39,0,39,0,0,"January 2025","January-2025-AE-by-provider-HyTsU (1).xls",0
2025-01-01,"Y02676","NHS England South East","Brighton Station Health Centre",0,0,1987,1987,0,0,0,0,NA,1,0,0,0,0,0,0,0,0,"January 2025","January-2025-AE-by-provider-HyTsU (1).xls",0
2025-01-01,"RXQ","NHS England South East","Buckinghamshire Healthcare NHS Trust",10375,1234,3481,15090,3310,0,218,3528,0.680963855421687,0.766202783300199,4204,851,0,5055,2362,7417,625,322,"January 2025","January-2025-AE-by-provider-HyTsU (1).xls",0
2025-01-01,"RN7","NHS England South East","Dartford And Gravesham NHS Trust",11094,0,3892,14986,3552,0,12,3564,0.679826933477555,0.762178032830642,3295,0,0,3295,438,3733,1062,449,"January 2025","January-2025-AE-by-provider-HyTsU (1).xls",0
2025-01-01,"Y00751","NHS England South East","East Berks Primary Care Ooh(Wam)",0,0,0,0,0,0,0,0,NA,NA,0,0,0,0,0,0,0,0,"January 2025","January-2025-AE-by-provider-HyTsU (1).xls",0
2025-01-01,"RVV","NHS England South East","East Kent Hospitals University NHS Foundation Trust",12952,0,12223,25175,6343,0,357,6700,0.51026868437307,0.733862959285005,3056,0,562,3618,511,4129,1826,1380,"January 2025","January-2025-AE-by-provider-HyTsU (1).xls",0
2025-01-01,"RXC","NHS England South East","East Sussex Healthcare NHS Trust",9936,0,3796,13732,3990,0,104,4094,0.598429951690821,0.70186425866589,3276,0,0,3276,485,3761,385,129,"January 2025","January-2025-AE-by-provider-HyTsU (1).xls",0
2025-01-01,"NDJ","NHS England South East","First Community Health And Care Cic",0,0,2070,2070,0,0,0,0,NA,1,0,0,0,0,0,0,0,0,"January 2025","January-2025-AE-by-provider-HyTsU (1).xls",0
2025-01-01,"RDU","NHS England South East","Frimley Health NHS Foundation Trust",22829,927,12305,36061,8728,4,224,8956,0.61767926759823,0.751643049277613,6324,0,0,6324,102,6426,2378,633,"January 2025","January-2025-AE-by-provider-HyTsU (1).xls",0
2025-01-01,"RW1","NHS England South East","Hampshire And Isle Of Wight Healthcare NHS Foundation Trust",0,0,2632,2632,0,0,56,56,NA,0.978723404255319,0,0,0,0,132,132,0,0,"January 2025","January-2025-AE-by-provider-HyTsU (1).xls",0
2025-01-01,"RN5","NHS England South East","Hampshire Hospitals NHS Foundation Trust",10341,127,2750,13218,4889,0,83,4972,0.527221738709989,0.623846270237555,4013,14,39,4066,1373,5439,623,195,"January 2025","January-2025-AE-by-provider-HyTsU (1).xls",0
2025-01-01,"R1F","NHS England South East","Isle Of Wight NHS Trust",4446,292,1329,6067,1831,0,0,1831,0.58816914080072,0.698203395417834,1275,0,0,1275,102,1377,462,169,"January 2025","January-2025-AE-by-provider-HyTsU (1).xls",0
2025-01-01,"RYY","NHS England South East","Kent Community Health NHS Foundation Trust",0,0,9305,9305,0,0,19,19,NA,0.997958087049973,0,0,0,0,0,0,0,0,"January 2025","January-2025-AE-by-provider-HyTsU (1).xls",0
2025-01-01,"RWF","NHS England South East","Maidstone And Tunbridge Wells NHS Trust",18769,0,2252,21021,3971,0,37,4008,0.788427726570409,0.809333523619238,5178,0,0,5178,983,6161,1256,274,"January 2025","January-2025-AE-by-provider-HyTsU (1).xls",0
2025-01-01,"RPA","NHS England South East","Medway NHS Foundation Trust",8537,0,8045,16582,3317,0,692,4009,0.611456014993558,0.758231817633579,1905,0,0,1905,523,2428,1144,756,"January 2025","January-2025-AE-by-provider-HyTsU (1).xls",0
2025-01-01,"RNU","NHS England South East","Oxford Health NHS Foundation Trust",0,0,3531,3531,0,0,314,314,NA,0.911073350325687,0,0,0,0,0,0,0,0,"January 2025","January-2025-AE-by-provider-HyTsU (1).xls",0
2025-01-01,"RTH","NHS England South East","Oxford University Hospitals NHS Foundation Trust",13583,1787,2613,17983,4909,0,5,4914,0.638592358094677,0.726741922927209,4627,137,20,4784,4564,9348,1049,0,"January 2025","January-2025-AE-by-provider-HyTsU (1).xls",0
2025-01-01,"AQN04","NHS England South East","Phl Lymington Utc",0,0,2657,2657,0,0,3,3,NA,0.998870907038013,0,0,0,0,0,0,0,0,"January 2025","January-2025-AE-by-provider-HyTsU (1).xls",0
2025-01-01,"RHU","NHS England South East","Portsmouth Hospitals University National Health Service Trust",11525,965,3547,16037,5389,16,107,5512,0.532407809110629,0.656294818232837,3461,0,0,3461,2579,6040,1726,349,"January 2025","January-2025-AE-by-provider-HyTsU (1).xls",0
2025-01-01,"NTP11","NHS England South East","Practice Plus Group Hospital - Southampton",0,0,5148,5148,0,0,268,268,NA,0.947940947940948,0,0,0,0,0,0,0,0,"January 2025","January-2025-AE-by-provider-HyTsU (1).xls",0
2025-01-01,"NTPAD","NHS England South East","Practice Plus Group Surgical Centre - St Marys Portsmouth",0,0,5419,5419,0,0,131,131,NA,0.975825798117734,0,0,0,0,0,0,0,0,"January 2025","January-2025-AE-by-provider-HyTsU (1).xls",0
2025-01-01,"RPC","NHS England South East","Queen Victoria Hospital NHS Foundation Trust",0,0,1279,1279,0,0,1,1,NA,0.999218139171227,0,0,3,3,444,447,0,0,"January 2025","January-2025-AE-by-provider-HyTsU (1).xls",0
2025-01-01,"Y07709","NHS England South East","Reading Urgent Care Centre",0,0,1959,1959,0,0,0,0,NA,1,0,0,0,0,0,0,0,0,"January 2025","January-2025-AE-by-provider-HyTsU (1).xls",0
2025-01-01,"RHW","NHS England South East","Royal Berkshire NHS Foundation Trust",11293,2391,2248,15932,4660,18,0,4678,0.587354998671744,0.706377102686417,2479,0,0,2479,482,2961,953,37,"January 2025","January-2025-AE-by-provider-HyTsU (1).xls",0
2025-01-01,"RA2","NHS England South East","Royal Surrey County Hospital NHS Foundation Trust",7240,0,1363,8603,2072,0,0,2072,0.713812154696133,0.759153783563873,2451,0,0,2451,1165,3616,427,13,"January 2025","January-2025-AE-by-provider-HyTsU (1).xls",0
2025-01-01,"NQT51","NHS England South East","Station Plaza Health Centre",0,0,1090,1090,0,0,0,0,NA,1,0,0,0,0,0,0,0,0,"January 2025","January-2025-AE-by-provider-HyTsU (1).xls",0
2025-01-01,"RTP","NHS England South East","Surrey And Sussex Healthcare NHS Trust",9612,0,0,9612,3640,0,0,3640,0.621306699958385,0.621306699958385,2940,0,0,2940,922,3862,1230,703,"January 2025","January-2025-AE-by-provider-HyTsU (1).xls",0
2025-01-01,"RDR","NHS England South East","Sussex Community NHS Foundation Trust",0,0,11327,11327,0,0,87,87,NA,0.9923192372208,0,0,0,0,3,3,0,0,"January 2025","January-2025-AE-by-provider-HyTsU (1).xls",0
2025-01-01,"RHM","NHS England South East","University Hospital Southampton NHS Foundation Trust",11728,1085,0,12813,4547,80,0,4627,0.612295361527967,0.638882385077655,4061,8,0,4069,1762,5831,520,14,"January 2025","January-2025-AE-by-provider-HyTsU (1).xls",0
2025-01-01,"RYR","NHS England South East","University Hospitals Sussex NHS Foundation Trust",26817,1364,1865,30046,10454,63,139,10656,0.610172651676176,0.645343806163882,8454,30,50,8534,1684,10218,2070,1176,"January 2025","January-2025-AE-by-provider-HyTsU (1).xls",0
2025-01-01,"ACH01","NHS England South East","Whitstable Medical Practice",0,0,5162,5162,0,0,0,0,NA,1,0,0,0,0,0,0,0,0,"January 2025","January-2025-AE-by-provider-HyTsU (1).xls",0
2025-01-01,"NTV0W","NHS England South East","Woking Walk In Centre",0,0,2535,2535,0,0,48,48,NA,0.981065088757396,0,0,0,0,0,0,0,0,"January 2025","January-2025-AE-by-provider-HyTsU (1).xls",0
2025-01-01,"RJ8","NHS England South West","Cornwall Partnership NHS Foundation Trust",0,0,0,0,0,0,0,0,NA,NA,0,0,10,10,81,91,0,0,"January 2025","January-2025-AE-by-provider-HyTsU (1).xls",0
2025-01-01,"RBD","NHS England South West","Dorset County Hospital NHS Foundation Trust",4188,0,3817,8005,1985,0,4,1989,0.526026743075454,0.751530293566521,1760,0,0,1760,556,2316,318,93,"January 2025","January-2025-AE-by-provider-HyTsU (1).xls",0
2025-01-01,"RDY","NHS England South West","Dorset Healthcare University NHS Foundation Trust",0,0,0,0,0,0,0,0,NA,NA,0,0,2,2,0,2,0,0,"January 2025","January-2025-AE-by-provider-HyTsU (1).xls",0
2025-01-01,"RTQ","NHS England South West","Gloucestershire Health And Care NHS Foundation Trust",0,0,7168,7168,0,0,42,42,NA,0.994140625,0,0,0,0,21,21,0,0,"January 2025","January-2025-AE-by-provider-HyTsU (1).xls",0
2025-01-01,"RTE","NHS England South West","Gloucestershire Hospitals NHS Foundation Trust",12378,0,0,12378,4600,0,0,4600,0.628372919696235,0.628372919696235,2635,0,0,2635,2408,5043,961,569,"January 2025","January-2025-AE-by-provider-HyTsU (1).xls",0
2025-01-01,"RN3","NHS England South West","Great Western Hospitals NHS Foundation Trust",5176,0,5001,10177,2581,0,109,2690,0.501352395672334,0.735678490714356,2350,0,0,2350,1424,3774,920,498,"January 2025","January-2025-AE-by-provider-HyTsU (1).xls",0
2025-01-01,"RVJ","NHS England South West","North Bristol NHS Trust",8202,0,0,8202,3297,0,0,3297,0.598024871982443,0.598024871982443,2920,0,0,2920,2321,5241,1022,545,"January 2025","January-2025-AE-by-provider-HyTsU (1).xls",0
2025-01-01,"L83087","NHS England South West","Okehampton Medical Centre",0,0,77,77,0,0,0,0,NA,1,0,0,0,0,0,0,0,0,"January 2025","January-2025-AE-by-provider-HyTsU (1).xls",0
2025-01-01,"NQT5H","NHS England South West","Paulton Memorial Hospital",0,0,913,913,0,0,5,5,NA,0.994523548740416,0,0,0,0,0,0,0,0,"January 2025","January-2025-AE-by-provider-HyTsU (1).xls",0
2025-01-01,"REF","NHS England South West","Royal Cornwall Hospitals NHS Trust",5987,0,10682,16669,3231,0,657,3888,0.46033071655253,0.766752654628352,2492,0,48,2540,1211,3751,1323,545,"January 2025","January-2025-AE-by-provider-HyTsU (1).xls",0
2025-01-01,"RH8","NHS England South West","Royal Devon University Healthcare NHS Foundation Trust",12574,0,4240,16814,5485,0,6,5491,0.563782408143789,0.673426906149637,3644,0,0,3644,1948,5592,2035,261,"January 2025","January-2025-AE-by-provider-HyTsU (1).xls",0
2025-01-01,"RD1","NHS England South West","Royal United Hospitals Bath NHS Foundation Trust",7900,0,0,7900,3122,0,0,3122,0.604810126582279,0.604810126582279,2539,0,6,2545,1807,4352,1040,204,"January 2025","January-2025-AE-by-provider-HyTsU (1).xls",0
2025-01-01,"RNZ","NHS England South West","Salisbury NHS Foundation Trust",4504,326,1715,6545,1752,0,0,1752,0.61101243339254,0.73231474407945,1312,0,0,1312,1026,2338,489,19,"January 2025","January-2025-AE-by-provider-HyTsU (1).xls",0
2025-01-01,"NLX","NHS England South West","Sirona Care & Health",0,0,8056,8056,0,0,378,378,NA,0.953078450844091,0,0,0,0,0,0,0,0,"January 2025","January-2025-AE-by-provider-HyTsU (1).xls",0
2025-01-01,"RH5","NHS England South West","Somerset NHS Foundation Trust",11562,0,9287,20849,5403,0,133,5536,0.532693305656461,0.734471677298671,2994,0,0,2994,1761,4755,1159,329,"January 2025","January-2025-AE-by-provider-HyTsU (1).xls",0
2025-01-01,"RYF","NHS England South West","South Western Ambulance Service NHS Foundation Trust",0,0,1635,1635,0,0,35,35,NA,0.978593272171254,0,0,0,0,0,0,0,0,"January 2025","January-2025-AE-by-provider-HyTsU (1).xls",0
2025-01-01,"AAH","NHS England South West","Tetbury Hospital Trust Ltd",0,0,599,599,0,0,0,0,NA,1,0,0,0,0,0,0,0,0,"January 2025","January-2025-AE-by-provider-HyTsU (1).xls",0
2025-01-01,"RA9","NHS England South West","Torbay And South Devon NHS Foundation Trust",6196,0,3020,9216,3055,0,14,3069,0.506939961265332,0.6669921875,2166,0,0,2166,1229,3395,466,70,"January 2025","January-2025-AE-by-provider-HyTsU (1).xls",0
2025-01-01,"RA7","NHS England South West","University Hospitals Bristol And Weston NHS Foundation Trust",14626,2376,0,17002,5610,177,0,5787,0.616436482975523,0.659628279025997,5092,10,0,5102,1747,6849,1877,909,"January 2025","January-2025-AE-by-provider-HyTsU (1).xls",0
2025-01-01,"R0D","NHS England South West","University Hospitals Dorset NHS Foundation Trust",12296,0,4726,17022,4996,0,0,4996,0.593689004554327,0.706497473857361,4019,0,0,4019,2517,6536,1527,484,"January 2025","January-2025-AE-by-provider-HyTsU (1).xls",0
2025-01-01,"RK9","NHS England South West","University Hospitals Plymouth NHS Trust",8603,160,4975,13738,4558,1,93,4652,0.470184819249099,0.661377201921677,2776,0,0,2776,1457,4233,1187,860,"January 2025","January-2025-AE-by-provider-HyTsU (1).xls",0
2025-01-01,"AXG","NHS England South West","Wiltshire Health & Care",0,0,2116,2116,0,0,9,9,NA,0.995746691871456,0,0,0,0,0,0,0,0,"January 2025","January-2025-AE-by-provider-HyTsU (1).xls",0
